------XM-?-B|-|-o-----X-o-T|M--?-E-MB---o-?---o--E-B?-TBE?--X-B---|-?---?----E---o|-|XTE-B-To|B|E-X-------o|---T--o-Xo---|-|Mo---B-T----To?-----o-T--|---M-------|M-T-X--||E-E--E-XM?-XXX-oXTT-X|--E-----
-----B--M?--?-oT|-B---XE--?-M|B------TX-B|----E-B----B----?--------E-T?-------E-E?E|---?-?-B--|oo-B--|E-?-E??-E-B--|-E-TT?-|T----M|o--|E-TM-BE--MXBM-?-TME--------X?---|M--o-M?XXE-E-E--|--?-|X-|-----o--
-EB-XX--o------B-|X---TM-EMo?----MEX--T----B--M-o---E-B||E--T-X-oB---o-----M|Eo--ET------?M-X|-E----E|--oo-BB-BE-|-XM---M--oB--T|oX-B---E-?---X-T----X---MT?---M-oT-E?----||XM-X-X-oM-B-?--|-??--T-XB-M--
-Eo--E-??---E-B-EE---MT-M--T-EB-o-B-M-o-E---T-----??-B--o--E?EX|X-B-----|EEX|--?o--M-E-T--|X-?----B-X--E-EB-|-B-T-Bo-----------MT-X-?B----E----|----o--?---o|-??--??X---?T-T-Bo--|-----BM--E---X-X----T--
----o-T-XM--E|----B-B----E--X------oEX-|-E--Xo|TT---?-MBM--MXX--EMM-EM|---T-M--B|E-M---E|o--MT-BM-B----|------M---X?-B-?--|--|-E-B---?TEM---?-M?M--X--M--T---XE-o-X?MT---E-B-----BT--B-E----E-X----oo-T--
--oo?o|-|MMoE|-E|-T--------T---M-?-E-|------B-MT--MoE---|-------|oo----BETE-T-|?-o-|-?-?-B------|o-?EMTo--X----|TBM----B|---------MB----ET-----MB-o--??-M-|?--o?-TM--B--------M-B--------?|ToEE---Xo--o--
-T-B-T-E--X-|--XM-----TM--o-EX---|X--oEB-E--TX--M--?TE?---?-XBMTo---XX--|B---|?--X---|T---Too?--------------E-E--X------T---XBB?M?--|--o-BM---|-EM|T---XE--XMT--T?EBE----E??-E-----X-?EE|---|-X--Mo-MTX--
-XX-|o?----T---E--TE?--o-E-Mo---M--BMo-XMB---|B--?|-?-M-|-T-|TT-B-EE|-X---ET-?EMXTE|X--M----Xo--?EX--Mo-?-----E-------X-BX--M----X|M|?---|X-B----TX-?--M-M-?X--B|M|--|-X|-X------M---TXE----EMT?-EXEB--v-
---XoM--E----M---X?-BE--E-M----B-|TE-T-EE----|--o-B--??-X---TT|E-------M---MoTM-|----X---?|---B--|-M||?--oo--X?--B--?--?|-----X-TTTX-----X-----E-XB---T?-o--------oX---?-?BX-T-?oX-B-ET-----ME----T|EB-f-
--|---X-T-o-TM-----E--T--T---M-----XBT-X-----|E-M-|EE-|B-X?-BBo-o--|B-B-BX|M|B-M?To---o-E--M?---T--|----|-??-B--M-??B---M----X-X--M--B----|--?-E-M----?XoXB--?--?M--BM---B------|-----|-BX?--M-?---XB-Mf-
-----|M--T--oE-|TE-B-MB-|--M--X-??-MT--TBT----?-M---T??ET---M?-|-X-o-|oB-EX--E-BB-o-o?E--?|---M|---|--E-EM--o-?B-X----MooTE-B---------o-M-M---oEXMXEoBo?T|T---B-E--X-E-M---X-X-T--M-X?o-B---XT--X------f-
---B?-o-|--X|-X--|--B?oB-----E--XM-o----M-ETE-?-|-?-Eo---oX-T-E-E--EMoT-oTMTEMo-|B--o|?B--X-T-M?o-?T--|BT??-X|-X?----B---M--|oEEo---B--X-X-M-----X-----o-MB?M---?--M---XE---M-|--oBoo-MX--o-----||X----f-
-----|o|X-T-oX-?-M?B-T----Mo??--??-?-?-T-----oB-M---X-?E---EBTT-o-?-T-o--E-EMEE-E-EE|M-----TXT-M-B----B-|---BX--X--Eo-o----X--X---o-M--B--B?--|--o|E--X??-M-M-|oM---|-TE----|o-?Bo-M-|------B----o-?-EMf-
-E-?-oTET??-?BM---T----?---E--oo--Bo-|X----?E-T-|-B---?---MEMX-Mo-|E?--|X|---------??E-T-XM?----??------MME?------TEoB|-o----?-|-E-|-?E----E-----|-|?-E-----X--XX|o-?-EB--------------B?--MXM--T--E-|--f-
m---E-E---o-------B-B??-|MM-T-M-----E-||--E-E-T---M----X----|-o-BBB-T---BET---?--EX-Mo-X--M-E-X--EX|M---|---|-E-------|--?-T-TX--?---M-|--XEBE--Xo---o|--?X--M-T-|-?M-B----MX---B-?--ETM--|E--E--?|ET|oX-
XXXXXXXXXXXXXXXXXXXXXXXXXXXXXXXXXXXXXXXXXXXXXXXXXXXXXXXXXXXXXXXXXXXXXXXXXXXXXXXXXXXXXXXXXXXXXXXXXXXXXXXXXXXXXXXXXXXXXXXXXXXXXXXXXXXXXXXXXXXXXXXXXXXXXXXXXXXXXXXXXXXXXXXXXXXXXXXXXXXXXXXXXXXXXXXXXXXXXXXXX
