-o----o-oM|-----?-X-o--|X----?B-o-o--BB--BT|-MX-B---TEMB|ME--|-|--XM-o-EE?|-?BB?-|M------ME|-EM--MTX-B--oT--M-B--EME-?--------|-TE--M|-M?--o-TXX-M-To---To|---oTT-EEB-M?MT-----B---T-B-----|XXE-TX---E--
-----o-?--?--X--|?X-E------E----X|---XMX-|---|-M-oB|XBE--E--B-----B?|MEBB--|-o-|BEX-oMMX---|-X-o?-X---M--T-||B--o------EM--M-B|o----?-MMM-|?---X|B-T--E?TMM----M------TMo-M-X---?---BX--B---o--o------E-
-E---o---|------oo-T-BE---?X|?T---?-|M|----??---o--TB-----M----X----oX-?-|----X?X-XoB-|-EB-BE--Bo?--o----?T|?o?---?o|-||-B-E------o--??---|-o--|TM|M---T---?E--B?-TX-------X?--XT-----B|--T----T-TX-----
---o-oB-o-|-E-------TB?-|-XTT?---B-E-|-T---------X--|-----o--EBMo?o-E--MoXE?-E-o---oE-EMT|---M--XX-T---TE?-o-T--o-------M---M-M?X--|--?-----E--T-----X---o-M|B-EEB?-|--?-E---E-------XXXB-X-oo--X|-M|BT-
-o-|-EM-||X|o-o-?EoBE|-----B|-E|-|-X----|Mo-B-E|---------M----?-M--B----?T-BE----o-T--o---E--M-XX-XXB--o-|---M--|T---ETB-o-M---T------T--?-T---B----M?XTX-TB---?ET--??-M-|oM-?X?-B-|M?EM---B--B?----|-E-
-|EE--B-XM-E-M----T||-E-|---T-o-T-T---oB-||E--X-M-X-M-?-?-B-B-B--TE-------MXo--|-----?oBT---o-X|-E----T|E--X-B||M-T---|-----o-M-||----B-M----T----MT-----TTMEE------?-oX-oX-B---||---|--------?-o-T---E-
----|?o-----o-Eo--B-ME----E--MT-BoTE-Mo|TT---M------B?BB|---T|---X-X--?------|-E-|--M-----o|?o-B----M---?-X-BBM----T-|-T-M-?XB-MMBX-MTEooo-----T-o---XEM---B-B--|-?----M--?----o|-T--BE---B------?B---|-
-?o?---MM|-M--?-o---E|BX-?B-o---X--XB-ME----|-B-??--B-E--|M|-B--o--MT---EM--EE-Eo--MX-oo|B----B-XB-XXEM|To----X-T---|--Bo---Bo-|-TT?---|-M--oE---------o-XB-?-oB-BX---o--MM?X-M-----XX-T--|---?--TM-||-v
-X-----E?-XT-EM---------?E?-T-o---MX---MX-M--B?|-o?T----|----E---XE-o-o--XoT--M-------M?T-XoTB-B-|M--M-X-o-----oT--T----X---?XTM---|-----o?BB--M?----E-?-M-?--MBX-?--X-|---o--oB-oB---------|-T--B-E--?f
-T---X|------o-|----T-X----?--BME-T-?--T-|-oE--B--B-B----o-?--M??---TE---Bo-M-To---ToX----T-X--M|-?B-?---ETM?X----|---M|-EB--|---?E---?|o---M------XT--TM-oB-E--M----B--|-BE-EEB--o?--BB-ME-?BX--o-T--Bf
--|-oT--E?E---B-?-E-M-XTM-BXB-T-X-ME-oM--|?-o-XB--|--Bo---E----?X-M?X-TTXEBo------MBM---?-MXBX-M---XB--BE-?-X-X-B---EMXB-?o----B-T?-TEM-B-oM|B--T-X---o---EE--T-----BXX-MB?--?T-|?M--X-TT-E--T|-BXT-B-of
-E-?oXo|-EE----M--B--Mo-BX-E-X??-T-B----M-----X-BBM---T----X-To---E--?-Eo-?---X--M-?-|-|BB?-o--ET?--oBMB-E-BT--BB-T|-M---|XB--ooX-o---B?---B-T-E-T||-B--B-X|--?B?-E-?M-|------X-?-???EB--?---|-BX--?--Tf
-X-|M---?-----T-----?B-B--X-XT-X-X--X--X|MB-o--M-T--Xo---|B|oTX-B--T--B?-------M---X--BT-oo-ME--M----XM--o--?-E?-o---oXo-T---|M---------MB-M-T-----E------?--B--B--|---Eo-M--X-|--XBoX---E?-?oME----T-|f
-X----||M--M---BT---ET-X--BX---E-|-B---|--ooM-TX-?-TET|-o---XB---o----X--o-|----|-o---XE-?-?Eo-TB------?E-E--X----o--|-oBM--ooM--B|----T--ET|oM---?---?----M-T?--Mo-?B-BT-B--MMM|--?-|-|---TBMB--XT---|f
m?Bo-|?T---X-oo-----?-oTT----?----TB---MB-----MX?-E-||T-o--MT|TXXME--|--MM-X------??B--E-X----|-------T----?-----M?o----?--T---T--MMB-------X---BMTo-B----T-T-?-B-X--?---|-----?-----|E?-|--E-?M-To-?T-X
XXXXXXXXXXXXXXXXXXXXXXXXXXXXXXXXXXXXXXXXXXXXXXXXXXXXXXXXXXXXXXXXXXXXXXXXXXXXXXXXXXXXXXXXXXXXXXXXXXXXXXXXXXXXXXXXXXXXXXXXXXXXXXXXXXXXXXXXXXXXXXXXXXXXXXXXXXXXXXXXXXXXXXXXXXXXXXXXXXXXXXXXXXXXXXXXXXXXXXXX
