---------oT------T------|BT--------T------TB---------|-------T---------------------T---T-------T---E|-------------BT------E---T--------M-T-----o-------B-X-----------------o--------T-To-------M--------
-------o--T------|------T---T------T-MBT--|---TX----T|-------T----T----E--ET---M-M-T-||--------|----|?---------E---T----------------B----TT-To-T--?T---o--------E-E-B--T------------T-T---?-----MM|-----
---B---E--|To----X------|M--T--T--TT---|--|---T--------------|--M--B---TT--T-----?---||M-------X---o------T------oT|---------------------|--|----------------E----o---T-------|?---B|-----|-------X-----
-----E----TT---?---EET--X---|--TT-T|M?-|------|-B------------|--------oT|--TTB-----X-|----|---------------To------|----X----------T-----o---TM--------T--T--E----T--o-------|-|-------X---|---|----T----
------T-M--|---T-E---|-|----X--||-T----|----T-------o------------------T|--|T-------------T-||------------TE----BT|E---X------T-o-----------|--------------------T----------|-T------T----X---T--|T|----
--------T--X---------T-|--T----TX-T---------X-?----------------|-------|X--X|--------T----|-TTMT-------T--|----o--|-----------T-----T-------------T---------M----|----E-------|---------B-X---|T-|-|----
-?--E------T-----XX--|-?-------T--T--?-----?XT-?------------T--|-------TX-----------M-T---T-||----------T-X-------|-----M------------T--T----T--------------------T--------------------------?X--T-|-|--
-----------T?-B-M--------------TE-|--X--T----T--------?-----T--|--------B------------X|---T--T----E-----|----M------E---B-----------M--------|------------T-----E-|--T-T----------------T--T-T---|---T-v
--?-------E|T-T--TT-T-------E--|-----X--T----|--T-T-----T---|--|---|---------T----o---T---|--|--B-------T--oT---------------------?----|-----|------------|-------|--T-|B-o-T---E---M---T--T-T---|---|-f
-----T-----X|-|-----B----T-------E--TXT-T-------X-------------MT---|--E------T---|--B-|---|T----------T-|-----T-----------B-MT---------|--T--|---o--------|-?-----XB-T---T--|-T---T-?---|--|-|---------f
---T-T------|-|E------o--T----B---?-----|-T|----X-T----------T-T---X----T?---|---|--?B---T|T-T----T---ToT---T-TT--o-B----X-----E-----M-|--------M--o?----------------|--E|--T-|---T----||-----T-------Tf
-T-T-|-TEB-XT-T--TTX-----T-T---|T--M----T-||---|--|T|-B----T|T-|----T--T-----T-T-|-----|-TT|-|-M--TE--|-|---|-|T-T--T|----T-----|--T----T------M-----|----?--M?--T-------X--|T||--|---||T-----|T--|--TTf
-|T||T-|--TXT-T--TTT---TT|-|T--TTT---TE-|T|-T|TT--ToTT-XTT-TX|---T--|T-T|-|-TT--T|--T-TT-||-T|||E-|-----TTT-|-T|T|TX|T---|T|TT-T|T-T|-T-TTTE--X---TT-T-TT-T-T----|TT---T-TT-||T|TT|T-T|TTT----T|-X|TTTTf
-TT|||-T-|TTTX|T-|TTT-TT|TT|T-T|||TX||TT|T-|T|-TTXTTTTTXTT-|X-T-TTT-T|T||-|T||--TT-TTTTX-X|T|X||-TT|----|T|-XT||X|TX|T|T-T|T-T-TT|XTTT|T||T-TTT--TTX|T|TX|TX|T-T-TTT|--|T|T||TTTTT-TT|X||||-T|TT|XT|T||f
m|XXXX||XX|||X||X|X|B-||||X||-||X||X|X-|X|-X|E-|XX-XX|XX|||XXX|XXX|X||XXXXX|XXXX|XX|X-|XXXX||XX|XX|XXX-X-|XXX|XXX|XXX|X|X|X|-|||||X||X||X|XX-XXXX||||||XX|XX||-|||XX|--X|-X|XX|X||-|X|X|XX|XX|||XX-X|||X
XXXXXXXXXXXXXXXXXXXXXXXXXXXXXXXXXXXXXXXXXXXXXXXXXXXXXXXXXXXXXXXXXXXXXXXXXXXXXXXXXXXXXXXXXXXXXXXXXXXXXXXXXXXXXXXXXXXXXXXXXXXXXXXXXXXXXXXXXXXXXXXXXXXXXXXXXXXXXXXXXXXXXXXXXXXXXXXXXXXXXXXXXXXXXXXXXXXXXXXX
