--|---B-X---X||------ooXT---oX--B-XBB-XT--X-----MM-------o-o----T-----X--E--|B-|--?--o-M--EB-M--?-?X-?---B-M?---B-X----TM-X--T-------------?--Xo-MX---BXX----o--------?----E-E?-|-|B-?o-B-----|----B--M-
-XT-X-T-TTTT-||X||||XXTXT|XXX|X--|?-|X|--BXXXX-|TT|To-|X-X||-TX|TX|||TTTX-XXTXX??-|XTM-?-|XXTX-?X|X-TT-X-|XTX-|X|XX|?-|X|MTTT-T-T|---|||TX|X||||-oTTTo--T||-X?|E-X--T|X-TXT-|-|XT-o|TT-XT|XTXT-|T|---XT-
-----Mo------------B--|T--|-o---?-Xo-----X-----------B---?------o-Eo------o--EB?-----oEE-M?-M-MB---E-------X---E-TX-MT-|-?--|--M-o---?M|--M----?--o||-T-o----|-----B--|M----To-EXTo-o---o------o--M-----
-oM----E--X---M------ET-B-X--BE--E------|-E----T-|----M--|------?--B-o------B-X--?---|------o-|------E|E--XTo----------Xo-ET-|-T-|o--M---X----B-|--B---To-------------|?---?--E---B---M-B--------X--E---
--B----M-------?-?-o--?-T--E-ToET-EE?B----E--T--EM--------E--MX-E--X-?-o--|??---|-----X-|-X-o--E-oo--------?E-|B-T--TEX-E|-------TE--M-ETTE--X---M-----?|-B----|--X-X--EM--M-XBM--B-o--E-T-EEM-T-E---EM-
----TE------E-XooM|M-?--BBo?--o----o---B-------E-M-T-----oEMX--E--TT------X-T|---?---XE---------|Bo---------E-BE-----o---EB------B-|X-ET---E--E-Bo---T----B-------?------|--E?o----B---|B---BM--o-------
--M-T-EB----?--------------?B--?---E-o-?--oE-X---------TB--To-----X---M|oo---?EB-----|--M----T?-?-MoM-|E?------o-T--BEX-?T---T-----?-X-|--T--E----T---E-E--M?------o?-M---T---X-T-B-T--------B-T---ME-E-
--EE-o--o|-XX---o---B---|---B?---E-|----EMo-M-?TE--M----BB--|TX-o----X--?-M-MM?--T-X-----T---o-E--oE-o---X---E----?M?X---?-|-B?----------T|-----T----X-----o------E?--E-?M-?-BX---T-BMX?-?M---B--------v
--B--o---MM--B-?-E--M--T---??-M?X----BEE-E-B-?|--M--M-T--M--oB--?-XM--E---XM-----------B--TT---o-?----MXT-?-----------|BB--EXE--X-T?-----oTT-MB--------Eo--MT---o---?------XM----T---EM-----XoMM----E--f
----M|--|----B---E?--EEoE---M-M-?--oo-B---------B-----X-----|-------T-?---BT------?B-EB--?--MMBoo-------T-o----TXXB-E--B-E|--|M|----?--X-X---X-?X?M|-T-o?-------o--E----X|oETB-M-X-o-X---------T-------f
-----M---o---o-----B-X-M-M-T--B----T--E|-M-----|T----?-Mo---E-M--MB----M---o---E|o------?oT-BoTBoo-|-|o-BTB----X-----??--|X--B----M----T--B--BoE-?E--?-T-------E?-------?---M-M-|E-|--?X---BX--B---TE--f
---------BT-o--|-----BM-M?------|o-----ETMM|M?M-------E|-TB--|TB-o-?--?---o--E-X-E-Bo---|-|-?|-?--X----o---|-M?-o?-T--M?--MT--B-X----?-BT-?----T-----XB--o--o?------------E-X--?---M|BXT--E-TX-X--B----f
-M----MM---E---?--E--------M-|-----------M---EMoM|X---B-XE--?-B--------M-------|XT-----|-|T|--o-X------?-?MEo--?-BT?T---T?-----|X-T---E----o-M-----?----X---oo-------M-E--X?------o----X-------------oXf
--M?E----X----------?-M-MEM----X------M?T--|-EX--|-o----||M-X-X---------X|------B?----XM-E--EB-?------?-XTT-----o|B-B----?--o---?--T?-?---|---?-|o------o--E--X----E-B--MX-X-----------?-------M--oM---f
m-B----X----?---X-XM-o---||T?-E?---E--|--T-M-?---XX-E----|?---To--M-----T---o-o--B?--oTX|--------?o|M-Bo?-----------Xoo-o--?-----?|---X--oM---B-|B--M--X-T-----M----|-||---|-X--oM---B-------T-----T---X
XXXXXXXXXXXXXXXXXXXXXXXXXXXXXXXXXXXXXXXXXXXXXXXXXXXXXXXXXXXXXXXXXXXXXXXXXXXXXXXXXXXXXXXXXXXXXXXXXXXXXXXXXXXXXXXXXXXXXXXXXXXXXXXXXXXXXXXXXXXXXXXXXXXXXXXXXXXXXXXXXXXXXXXXXXXXXXXXXXXXXXXXXXXXXXXXXXXXXXXX
