-T-o--B---EET-------Eo-B-o--?----E-?--?-ooo----T---B-X--X|?T--MBT|-To-o-TT-XT?--E-o-?--||T--o-o-------o--EX|EEM----M--?|E----M?TT-----?----TXo-------E|-|--|--Bo?----?----|-XM---X--oB---T----Mo-M-B-E--
-?TT-o-B---TE---MM--E-oX-B--?-BBB--MM-o-TME--XB----MXB?--oXTX----|-Bo-o-E|EB|---B-|--BM-XB--TT?---oB-BoB-ToX-E|--B-X---?----|-E----M-M-|B---M-?--o-ET-?oX-B-T----XX--o?-XM--BX-o-o---E--?-----T--E?-----
-M----B-Xo|----|-o---E|-TBT-----oM--EE---M--?---B-EM-XMo|oT--BB?E---o--ET---T|----|-ToT?---?-BX??Bo----oBT---E---T-ET-X-E-E---E-----E--To--?-TT----||X|-----oX----|-B------?|-?---MT-|To?T?--T--------T-
----T|T|-?X----TT---?-M|---E----o-E-?M---?-T--T--X---TX?-|XT--E--|-?-----E------E------X|--?-X|--?-T-|-B-X-T--T-B-o-E|--T-ME-|--B-TM-B--?T-----XMoE-------|MMT-B--o----M---|-?-E----XEX---B?-MXE--?-----
-ME-T|E-o?-T--o----X?E----Mo----XMX--o--o-M--B--E|T|----E|-X---|B?--o-|TTo-XM|-|B-----o---?---B--T--oM-o----E---------E------o-?--E---X|BE--T--B-o-MX-|--------X----?BTEE|-B---X|E--E?-MX-T--XT--oT--Xo-
-?-?--oXo---BoTM--o---E-----E----E--|?o----E?E--E---X-TEM|BTX-E--BT----?-?--MoE----o-------X-T-MT--M-T----ME----BT--o?X--TX--|-EXMM-T-?--B---B-o-T--BXET--X?-E--|??oBE-M------BE----B----|TBBM--|E-Mo-T-
-E--X?---T-T------BTB-B--|--B--|oMM|----E-E-X----T-E?-M|--|---o-M--B-----o-BTB?----M-----------?----|--?--o|-T---o-Bo-E-TT-XB-|B----MoToM-TET---?|T---B-E---oXMB---?|---oTB---?XX---Eo---?o----TTTXT-|--
-|X--T|-oBE----?T-XT---B----B-o-T--T?|XME|?-X----M-|---X------T|BE-?---?MT-?EEBEXEX?--X|----To-B-?ETEXET---M-|B-M-|-T-X-B--T-B--E-----o--|----?-||-Boo--T?|------------|?Eo-Mo---E?-E-?---oE|-MBoE-B--Mv
--E||BE-o--X----|o-|X-----o--X|MoE----?T-XE-B---?--|M-EB-X--?-?-?-?X--X-----E?--T-----T|M----|-XB-E-T--X-E-----o-M--M-B---oX--o-oo-----M--EBo-Eo-??-?B-E-?--ooTX-ToX----B|----TXE-E|||----?M-T-M|-B-|--f
----M---BX------Moo-|--o-M---oB---B?oTXo----o--EET?-?---oo--Eoo-EEX-----T--------X----X?-M---X--M---EB--T?-XE---E-B-?-E|-M?-XT---o----o||--o-E--BE-?o----XXEE--|-oo--o|??--X-oT--T----XX--oo----X--B--Tf
-oo--T-E----M-----|oTo-|-Eo|E-oX-|-M-E---|o----o-?-?B---T-|-TB-E-X-|TEBX-T|?----M-T-M--B-T-o--TTo?TME--ETB-M-XoX-E--ET-T---BMX-MX-BT?--ME--MX?-|EMo--M|---X?---o-T--E-EXB-T----T--?MT-----|X-M-T??EMTMMf
--E|--o---?BXX-TMMB-E-o--XT|-|-TXBTT?-EBB-Moo----TX-M-M-X--B-MM-B-o--M--|--|---To------XMXX--M-?--EM|-|--X-------?--T-X-T-??--X-TM-?------MX--B-T---B--o--|XoEo-------T--E---||--TB---T---E----E---TM--f
--X|TE--?-Mo--X----o-X---BEX----|--T--||---TX?|-|-TT-Bo--?-|?XX-----M------?-----|-E---E---BX--TT---?----E-|M-E--ME-----?-T---M--Bo?----T--B--M---ETMBB-|----|-EE-E---B-?-|-X-ETT-X-o-o--Bo-?-|----B|-Tf
-?B-o-ET--EEM?---||Bo--M|?X-|------?--E-E--BE--M?ME-EBE-E|---B|-T--X--?BBo-T-|----XE------Xo--X----X?--X-?---o-M-oEo?M-MTX?M--B-M---?-T--|-?B---XoM-oo--MBoXX--B---?|EBB-ETBo---?-o-TB--XXX-TM-E-ME---Mf
mM-o?M|B-M----??-E--T-oM---|---Mo-M--Bo----Bo---EE--o--|-E----B-T-T-----X--|?E|-BT?--E--E----T--?E-|oET|--XT-TM-?-X--E----?-ETTo-Xo??XX--o----TBE---T---TM---X-----||-B-B-o?-E|T|o----M--X-T?X--o--?--MX
XXXXXXXXXXXXXXXXXXXXXXXXXXXXXXXXXXXXXXXXXXXXXXXXXXXXXXXXXXXXXXXXXXXXXXXXXXXXXXXXXXXXXXXXXXXXXXXXXXXXXXXXXXXXXXXXXXXXXXXXXXXXXXXXXXXXXXXXXXXXXXXXXXXXXXXXXXXXXXXXXXXXXXXXXXXXXXXXXXXXXXXXXXXXXXXXXXXXXXXX
