---------o-------T------TBT--------T------TB---------T-------T---------------------T--TT-------T---E|-------------BT------E---T--------M-T-----o-------B-X-----------------o--------T-To-------M--------
-------o--|------|------T---T------T-MBT--T---|X----T|-------T----T----E--E|---M-M-T-|T--------|----|?---------E---|----------------B----TT-|o-T--?T---o--------E-E-B--T------------|-T---?-----MM------
---B---E--|To----X---T--|M--|--TT-TT---|--|---T--------------T--M--B---TT--T-----?-|-||M-------X---o------|------o||---------------------|--|----------------E----o---T-------T?---B|---------T---X-----
-----E-----|---?---EET--X---X--||-||M?-T------|-B------------|--------oT|--|TB-----X-|--------------------To------|---------------T-----o---|M--------T--T--E----T--o-------T-T-------X-------T----T----
------T-M--|---T-E---|-T----X--T|-T----|----T-------o------------------|X--|T-------------T-TT------------|E----BTTE---X------T-o-----------|--------------------|----------|-T------T----?---T---T|----
--------T--X-----X|--T-|--T----TX-|---------X-?----------------T-------|X--X|--------T----|-TTMT-------T--X----o--T-----------T-----T-------------T---------M----|----E-------|---------B-X---|T-|-T----
-?--E------T-----XX--|-?-------T--|--?-----?XT-?------------T--|-------TX-----------MX|-----||----------T-X-------|-----M------------T--T----T--------------------T----T---------------------?X--T-|-T--
-----------T?-B-M--------------TE-|--X--T----|--------?-----T--T--------B------------XT---T--T----E-----T----M------E---B-----------M--------T------------T-----E-T--T-T-------------------T-|---|---T-v
--?-------E|T-|--TT-T-------E--|-----X--T----|--T-T-----T---|--T---T---------|----o---T---|--|--B-------|--oT---------------------?----T-----|------------T-------X--T-|B-o-T---E---M---T--T-|---|---|-f
-----------XT-T-----B----T-------E--TXT-|-------X-------------M|---|--E------T---T--B-|---|T----------T-|-----------------B-MT---------T--T--|---o--------|-?-----XB-|---T--|-T---T-?---|--|-|---------f
-|-T-T------|-|E------o--T----B-|-?-----|-T|----X-T----------T-|---X----T?---|---|--?B---T|T-T----T---ToT---|-TT--o-B----X-----E-----M-|--------M--o?----------------|--E|----T---T----TT-----T-------Tf
-T-|-T-TEB--T-T--TTX-----|-----TT--T----T-T|---T--|T|-B----T-T-|-------T-----|-T-|--T--T-TT|-T-M--TE--|-T---|-TT-|--|T----T-----T--T----T------M----------?--M?--|-------X---||---T---T|T-----|T--T--TTf
-|TT-T----T-T-T--TTT---TT||-T--T|T-XT|E-TT|-TTT|--T||T-X---TX|---T|-TT-|T-|--|---|--|-||-||-T|T|ET|----||T|-X-TTX|T?||---TTTTT-T|T-|T-T-TTTE--X---TT-TTTT-T-T----|TT---T-TT-||TT-T|T-TTTTT----TT--|TT|Tf
-TT|T|-|-XTTTTT|-|TTT-TTT|XT|T|T|T-XT|TTXT-TT|||TXT||TT|TT-|X----TT-|TT|XX||T|T|TT--XTT||X|T|T||||TT---|TT|TXT||XTTX|TTXX|||-T|T||X|TT|||TT--TT--T|XT||T|TTXTT-T-TTT|--TT||TXTTTTT-TT||||XT-TTTT|TTTTTTf
m|XXXX-|XX|||-||X|X|X-X|||X||-||X|-X|XX|||-||E||X||X|||X||-XXX-XX||X|||XXXX||X|||X-XX-||XXXXXXX|X||XXXXX-|X|X|XXX|XXX|XXX|X|-|||||X||X||X|XXXX|-X||X|X||X||X||-|-|XX|X-X|-||XXX|||||||X|XX|-X|X|X||||||X
XXXXXXXXXXXXXXXXXXXXXXXXXXXXXXXXXXXXXXXXXXXXXXXXXXXXXXXXXXXXXXXXXXXXXXXXXXXXXXXXXXXXXXXXXXXXXXXXXXXXXXXXXXXXXXXXXXXXXXXXXXXXXXXXXXXXXXXXXXXXXXXXXXXXXXXXXXXXXXXXXXXXXXXXXXXXXXXXXXXXXXXXXXXXXXXXXXXXXXXX
