---T|-T-------T--o--MET-----X---o-M---TM--o-M-|-TE-T---EMo----ET-X?-oo---|X---o-E------M-X-|-MoX-T?o-X?|-----||EE--T--M-----To-oE----B----T|-----T-o-M----T-MTo?-B-E---XT|-X-?-B---BEE---------X-oX-B-o-
-?----EE-E-----o-Eo-|--TTMoEo-|-?--M--o-?TBo---o--M?o-----|XMM---?-----E---o-|o?---|---TT|--XXE-XT?-?-XoE----M---X|?-|-----E---E--|-|-B--|-----?TX-E?--?-TEMB-----|----T|-E-BB---E---BE-o--B?--MTB-T-B--
-|-??-oM|-X|-?M--|---TM|o??-B--BB--M-|---|--T----T-o--------BoT-o---T---|TM-M-|E-------|----T------E---X--E--?---o------o-?---|-BE-XM-X?----EB-B------M-MB-------?-M----E--EMME-M-|T?TM-|-oM|----|X-ET--
---M||X---?---?|----------?|MT----o-X-EB------EEo|---TM-??--T|o-E-|--T?B-E---M---?-?-----o?-o--|-|--E--?BX---E?--|--?---|-B--T----EMM---oT---B?--ME|-X-?--?----B-|--B-TB-----||-M---E-?--|-T------TT--X-
----T-o--?X---TTT---T-ET--?--M----MMo?XEX?--||M?-E|o-B?-?T--X-E------BB-X----B-XoEEMBE----o-T----TT-|---|---?o-|--M|X-T-X---|XM---E-?X-To--XBT?XE?--T-XX--B---?----oXXoB----o---BMX--?-E------M-o----XB-
-?---oE?EE-|B|||BX-|o---XB-E------?-BM--?B||T-M-BX-??--BX--E------------|-??-B-T---E----X--|?-X----B--T--------M-B-o-EM--?M-|--BT----?X|E--EoM--oB-|?--XX----BT--MMB--E--?--|-?----?|---B----MMM---o-M--
---oE--TE-----?E-o----EB---o|---BEo----|??MT-B--M--o--?-?-E-T----?X-X--TX---B?-B-B-TX?X-|T-----?-|oM--M?-BX---BM---X-?-----TT-|M-|--M-B---o--BEo-?--XM-T-?-Mo-------|B-----BMX|--B-TE---BM---o--Eo-o-Eo-
--?--M--T-B-------?|o-oBX----E|-----M-E-oXT----?X--MX-o--BM|T?-T-o??----o-E---oEEXM-----?--E-----oB?---o|Xo-T-T-M----||--T----|------|---BE-----BT-|---EX-|E-B-o--M--?|?|BT--T?M?X?----BMoE-EX-|-?-----v
--|-XT-----oEBX--o-------?EBM--X-M----|----o-----MM|--??---------o?BT--oBBo----o---o|M|X-----BXTT-----X?-TBB----oME----T-------B--E-oX----T-B---|--Xo----TTB-M--M---E----Eoo----?E---EX------M-TTBXM-|-f
--BT-T|E---o----T----T--o------X--|--X--|E-B--B-o-M?o-?B--|-X-|------ETT|X-o---BoTTEoT----?-ToM-oB-M-E-?--|---EM-TBE?-------------?-o---MT-oTTE-?--T-o?--|-XX---|o-XE??X--??--?------?------|E----|--B-f
--T---------oME--?E?-----?-T---oEM----E-----|-E--E?-?-T-|-----MEB--oM-?-|-T--|-----X--?--B--TETXX-|-B?-B----Eo----E---|-T--------|--B--BTE-?T|---XB----T-B--?---EM?-E--?Xo-------Xo--BX-BB--|-BB-|B|oTEf
-?M?X-----|BEX----EM--E--M--|o--|T----XB?---MoB-E-?-T--oM--|---B-Bo-B-E--E---E---|--o---X---M-EB--------MM--B--oXM-TT--o-o------|T-|--E----MMMEB---?|-?Mo|T|--MMT-----XM--|-TX?--|---o-To--M--X---EX-Mof
-|-BXMXET|-EET?Xo--X--X---B--?----M-----T--E-X--?XMTTE--?-XXB-??-------B-?||----|-----T-----M|-|BB--BT--------E-EE---E-?--X-E----BT-?X-B-----B?---E--|TT-B---E|---T-|-?ooM-B-------T-M----o------X-M-?-f
----------|M-XE----?----X-X?B--X--T|o--?----E--XM--B-T-?-X-o|BE--|-----T|?--X--oo?----|--Mo--|--|M-?-BE--?--?T-E-M-?BM-B-BT--|MX-oMX-?o---M-B----|TX|X----B?--------B---M---M--M?----|-------X----TB-B-f
m--TE---E--|EE?--E----?-X-----M?X---|--------?-|Xo-----B-----oMBTB--------?-X----o-|-E--|-Mo-B-----BX---M--oT--X-ToMX---X-T-TB|||X--T-T-?--TB-B-E-EM|o-TXT---?o------o--TMMTX---B--|---MooX-B-|-M---EoTX
XXXXXXXXXXXXXXXXXXXXXXXXXXXXXXXXXXXXXXXXXXXXXXXXXXXXXXXXXXXXXXXXXXXXXXXXXXXXXXXXXXXXXXXXXXXXXXXXXXXXXXXXXXXXXXXXXXXXXXXXXXXXXXXXXXXXXXXXXXXXXXXXXXXXXXXXXXXXXXXXXXXXXXXXXXXXXXXXXXXXXXXXXXXXXXXXXXXXXXXX
