---------T?X-M-|--EE-T-X-E-X-B-------M|-TE-----------B-|---M------o--o-|X--?B|---------XB|-X------T---o-|-T-X---|-|-MXT--??--Mo--o?-M---E-ET--------------B--E--o--?E------X--------?--BX----ME|X?E---?-
-B---M-E-X--M-B-E-EE-?-E-----|?-o--M----?----B------M--E-Mo---?--MX---------?-X----T-|-E--------?--X-o?--|--|-T|T--?-X-------oME---|T----?--T----|------B-BB--MBoBEo--M---|TM----BT---E-o?--M|?--B----B-
--o-|o-X--B-XB----MT-X---------E------B-E------B-o--?--TB----B-----?--M----T-X-----X?E-?--------B-|B--MB--X-|B--?------T-----|-?-------X-----B?MB??-----X--B-B-?E-T---B-M-o-E-ToB-X---M--o?X-T---|--o??-
--?B--XX--?--E--T---X--o--B-T-X-o----E--|-MEXE--M-?E|E-X-MTTo|T-T-o-T-M-MEB-o----M---Mo--|TM----|--||--|--M------?---B--B-T-?-E-----?-BE-XX--M----B----|---X-|B-XTo----|-B------X-----B---E-T----?-o--M-
--EEXB|--T---o---E---M-E---XM-----?-?---TE--E--?X-------B--X|-EEB?--B?EX-Eo?--T-M-|EX-BMo-T----B-E--o-M-o---oM------E-oo|X------------M----o--B----------?----?------E---MT--|---E---?-?--E-------|--BB-
---?--T-|--o----M-oET--||-----M---E-MTo-----X|-BB-o??-|EX-T-?--oE|---|--------|?--o----?--|----E---o----|--X----M--|BE-oo?--?----B-TM-o---X?X-o--?-M|-|-E-E----------BE---|-------|Eo--?----X--|---|----
-----X--EEo?-----------------|---|--M-o------X|T-|----M-B-X---o------|-|------T--M-?o---X----M-|XBTE----|-E-?----|-----|--?---B|--EMXT-|----------oXoM--------X-------M---T?---BE|-----BM?-M----XB----|-
-?--------B----E--BMBo------EE---X--T-------M-?---XT|T--B--?oT-X--B----B--------|-o--o-o--------B--|-?--XMo-----|EM---?--X?-----B---B-------|--MX-X-B---M-?-----------M-BB-E-E?-o--|B---T?-E-|-o-X-----v
-oBTB-T|-M-oX-X-T-----o?----?--M--------o--?-B-E----------XT-|-------E----Bo---Eo|-|-XX---XM---T-o---Mo-T|o----|-?-----TE?-?--T--------Xo---T-?B--|-BB----M----B--X-E--------------XXX-M--------o---X-Ef
-B|---X-X-o-o--M-oX-E-XM------o----MTo-o----?B--o---o-|--X--T---o----------oo-E--?-o----oE---?----X-M?T?-o-ToB--|-----?o??-o---?---E|-T--------BB?-X---??|--?--E?o---|B-----ETo---T---??--o---T--B---M|f
-?B----|--|--?|-X------E?o--?o--EB---M------XT--o---?----oT--T-MB--|--B-?B-T?-E?-oT|?E-?--||-XX-?-o---M----E--M-oX--X-B-|T----E--o------X-|T-?|EE-?E------M-X-o-o-B-|-o-oB-X--TX--------?-TX---|-E--?--f
---E--|E-----X-E-M----B-o--|X-oM|B|B-BMoM--E----?------|-B-To---?--oT-----T--o-----|B|-----o--XX--|-o----E-?--?----XB-?-----M-T-----M--To-o---|---XX-B-MM|--|-------MM--|--M----MMT-B---|o--T-o-------|f
--B--|-|T-|---?----|----T-E-XM--X---o---T-|--|---X-oM-T--BM?--M----M-oB----MT--||--M--E---|--E-----|-E--|---X------X-|X-T-B||-XE-T||------T--BMB--|TB-?E---|--M-|B----|?B---B---T?------?--M-B----o----f
--B---|-------B----X|--E------B--T-|-E----|-E----------oB?TT---B?BB--E---M----B--?-X--|TX?X-|--oT|X---B-o-M------E-X---o-?-----o---T----TX-T|?-?-?BB---TXoB------B-o?oB----?-EM--T-?---E?-|-M-X--X--?--f
m----M-M-oM--ME------X---?o--o--?---E--T-T--T-?E--?M--X--?ET-T--------|--B--B-------X-TM-o|-?XX--E-?-M--TX-?-?--T---|-o---o------|B-T-X-T---TT--X--|-T|-EM-o----|---M-o-E----E----------?o-Bo---E---MB-X
XXXXXXXXXXXXXXXXXXXXXXXXXXXXXXXXXXXXXXXXXXXXXXXXXXXXXXXXXXXXXXXXXXXXXXXXXXXXXXXXXXXXXXXXXXXXXXXXXXXXXXXXXXXXXXXXXXXXXXXXXXXXXXXXXXXXXXXXXXXXXXXXXXXXXXXXXXXXXXXXXXXXXXXXXXXXXXXXXXXXXXXXXXXXXXXXXXXXXXXX
