--|---B-X---X||------ooXT--|oX--B-XBB-XT--X-----MM-------o-o----T-----X--E--|B-|--?--o-M--EB-M--?-?X-?---B-M?---B-X----TM----T-------------?--Xo-MX---BXX--?-o--------?----E-E?-|-|B-?o-B-----|----B----
-X-X|-?XXTTT|||X-TT|T|EXT|XXX|X--|?-|X|--BEXXX|T|X|To-Xo--||-TT|T?|-X|T|XXXTXXX?T-TX|MX?T|XTT|X?|-T-TT-T--T|--|X-X||?--X|MX-T|T-X||--|--TX|X||-|-X|TXo---||XX?|TXX--T|--TT|-|-|XT-o-|XT-X|X||M-|TXTX-XT-
----oMo---------B--B--|T--|-o-----Xo-----X-----------B---?------o-Eo------o--EB------oEE-M?-M-MB---E-T--X--X---E-TX-MT-|-?--|--M-o---?M|--M----?--o||-T-o----|-----B--|M----To-EXTo-o---o--XB--o--M---X-
-oM----E--X---M------ETXB-X-EBE--E------|-E----T-|----M--|---X--?--B-o------B-X--?---|------o--------E|E--XTo---------MXo-ET---T-|o--M---X----B-|--B---To-------------|?---?--E---B---M-B--------X--E---
--B----M-------?-?-o--?-T--E-ToET-EE?B----E--T--EM--------E--MX-E--X-?-o--|??---|-----X-|-X-o--E-oo------M-?E-|B-T--TEX-E|-------TE--M-ETTE--X---M-----?|------|--X-X--EM--M-XBM--B-o--E-T-EEM-T-E---EM-
----TE--------XooM|M-?--BBo?--o--------B-------E-M-T-----oEMX--E--TT------X-T|---?---XE---------|Bo---------E-BE-----o---EB------B-|X-ET---E--E-Bo---T----B----|--?------|--E?o---EB---|B---BM--o-------
-XM-T-EB----?--------------?B--?---EMo-?--oE-X---------TB--To-----X---M|oo---?EB-----|--M----T?-?-MoM-|E?------o-T--BEX-?T---T-----?-XB|--TX-E--X-TM--E-E-TM?------o?-M---T---X-T-B-T----------T---ME-E-
---E-o--o|-XX---o---B---|o--B?---E-|----EMo-M-?TE--M----B---|TX-o----X--?-M-MM?--T-X-----T---o-E--oE-o---X---E----?M?X---?-|-B?----------T------T----X-----o------E?--E-?M-?-BX---T-B-X?-?M---B--------v
--B--o---MM-XB-?-E--M--T---??-M?X----BEE-E-B-?|--M--M-T--M--oB--?-XM--E---XM-----------B--TT---o-?-----XT-?-----------|BB--EXE--X-T?-----oTT-MB--------Eo--MT---o---?------XM----T---EM-----XoMM----E--f
----M|--|----B---E?---EoE---M-M-?--oo-B---------B-----X-----|-------T-?---BT------?B--B--?--MMBoo-------T-o----TXXB-E--B-E|--|M|----?--X-X---X-?X?M|-T-o?------?o--E----X|oETB-M-X-o-X-----------------f
-----M---o---o-----B-X-M-M-T--B----T--E|-M-----|-----?-Mo---E-M--MB----M---o---E|o------?oT-BoTBoo-|-|o-BTB----X-----?---|X--B----M?---T--B--BoE-?E--?-T-------E------|-?---M-M-|E-|--?X---BX--B---TE--f
---------BT-o--|-----BM-M?------|o-----ETM-|M?M-------E|-TB--|TB-o-?--?---o--E-X-E-Bo---|-|-?|-?--X----o---|-M?-o?-T--M?--MT--B-X----?-BT-?----T-----XB--o--o?---------?--E-X--?---M-BXT--E-TX-X--B----f
-M----MM---E---?--E--------M-|-----------M---EMoM|X-----XE--?-B--------M------?|XT-----|-|T|--o-X------?-?MEo--?-BT?T----?---X-|X-T---E----o-M-----?----X---oo-M-----M-E---?------o----X-------------oXf
--M?E----X----------?-M-MEM----X------M?T--|-EX--|-o----||M-X-X---------X|-------?----XM-E--EB-?------?-XTT-----o|B-B----?--o---?--T?-?---|---?-|o------o--E--X------B--MX-X-----------?-------M-MoM---f
m-B----X----?---X-XM-o---|-T?-E?---E--|--T-M-?---XX-E----|----To--M-----T---o----B?--oTX|--------?o|M-Bo?-----------Xoo-o--?-----?----X--oM---B-|B--M--X-T-----M----|-||---|-X--oM---B-------T-----T---X
XXXXXXXXXXXXXXXXXXXXXXXXXXXXXXXXXXXXXXXXXXXXXXXXXXXXXXXXXXXXXXXXXXXXXXXXXXXXXXXXXXXXXXXXXXXXXXXXXXXXXXXXXXXXXXXXXXXXXXXXXXXXXXXXXXXXXXXXXXXXXXXXXXXXXXXXXXXXXXXXXXXXXXXXXXXXXXXXXXXXXXXXXXXXXXXXXXXXXXXX
