-------oM--?--XB-ETME-E-E?-E-E----BE|E---XXB-o--E-M|--E---B-E--B---|-o----E-B-?----?--M---M--X-----?-M--o-?o--EB-o--MM-?---TE---X--|--o--E---MX-To-----BMB--?o-o-------|--o--|-ME-XX--M-?----M-X--E--|--
--------?TX|---B--T-X--T|--|-o--ME-XX|--B-|X?-E?--E|Eo---X-E-B-E-o--E||---?--TB-Mo|------BTX--o---??X--|-o-T--B----|--||--T-TE-XBT--------B-?--?BB-EB|X---B---|-?----o-EM----o----B--o---X--|-M------BX-
-|-TEE--MXM-?--T--T-XE----B--oT-TX-T---|E---M-?E?-?-Xo--M-E-|B-o-X--X-X--EoE----|ToE----XM--E-B-T-X---BT-M-----E|?-X---?XBB-B----BoX-E-?-EEE-o---?---o??--X-M--|-----T--X-T----?--o-|--?-B|E-B-??--TT-T-
---M--?T-Mo------TM|----METEMM-EE-Bo--?o|-------o-----?oE-o--M-XBo-B|------T--o-|---E--oE?X-T-BX--------TB-E--?EBMBXT|E----|oTM--MX-E--oBE-?B-XX-------T--?o--T?|-?o?M-----TEE--BM------B---XE--T-|-B|E-
--XB??E--E|-o---|-|B?--X-||--?---MX--?-T-T--?-?E--M---?MBX|--XE--EXM-M--B--M--o?-T|----|oX--------XB|---XE-X-oo-|-----oo?-----B---T---ET-MM?---T-----oT?--E-T-BT-BT|--M----T---------|-?|--oTo?-MTMBX-|-
-----o?----BM----B-|------oMT---E---oMM-XT---E-T--T-TE----oM-----?o---Mo-X--|BE----o----oo------T-E---XEX-oT|-B---oM---oE--B?--o----X-E--|BToM---X--XXoTX---oXEo--TT-XXo--oMM--?E-X-o-|-B----?|Xo-B-M-?-
-|-?-ET-E----X-X-M-M------M-|E-T---|-?-------|-?X?M|o-oX|-Xo-Eo---?---|----o-B--------M-?|M-X-?-B-B?TXTE--|---|-E?-E---|--T--?Xo-B-EE-X---o-|-|XT--E------E?-E||M--T--B--XXo---ooBXE-XM-|-Mo-|-?|-------
-?oE--B---o----TE--T---|---M-|--M|-o---o-M|oo--M--o----XT-T-X--XM---TE-EX--T----B----E--X--T|E--o--?MTMX?EE---?-B----E-?BE?T-?EBMB?||--X-EE-?E-|X-M-?M---T-|o|----B-?BT---oEXT---M--XT--TTTTo|T-||M----v
-E-----|--E-?-M||o--o-M-M-TET---|X----?--o---B-X----ooB---BEXE--M?-M-M|--------?-E-T-E---X?-MEBoB?------|T|-BTT-TT--?-|-o-?--?----T?-T--?-|-EEBT--B--MMB-X------|-------?-E----E-E-?-T-o-Moo--X-X-T--oEf
-|----o-----T--oo-?-X--EMo--T----oM------E?-M---M--T-MB-EB-XTT-o-B-M-|-EM-XE--B-T-o-E--o---E------|----M--MX-------o-M--M|---?BBM-?--B--|---XX-oE---MTE|-T|--------To-T-BoM?T|---E-E--E?--------T------f
---?B-|B?-|M-MX-EMM---E--X-E----E--o-E--o-EB-M-TT-o--EB--E----T-B---M-TM|-TE|-?M--EBB|T---?-|-B--oE----TB--T--M-|-T-B|--M----?-?XXE-T----o-M-M--?----E|X|---T---M|B-ET-X-o---M---E-|----o--BoB?----?-B|f
--T--E-|-XB--M--?---M-|BB-XT---ET-o--X-TMB-T-----B-T-M------|-X-B-EEMM?-ME---|--?-XT---Xo-?-M---B----o-B--X-T---o|--TX-E--?M-E--XT--XM|---E--B----T---?----------X-MT??-E----M-EXX----BE|X-M?---T-B--oEf
----E-B--o-B-E-o--||-------X--M---B-----T--Bo-XT---?-?BME?--|M-oo--oEE-?X------T?-BB---?-XX---T--o-X--?X|B-BE-Bo----X--EEEM?---|BM---T-----To|---o?----o---T|XM---oo----o--B??B?-|---o------E|Boo--X--of
-X-------M-TX|-E-|-----X-X-BE-X?-------E--BT-XBT--X|---M---T------------B-T---EB|---M-|BM---|o-------B?-?----E-----B------E-?-----E?--|-?|oB--T-----M----??T---M?--X-M--ToEM?-?-|X--MEB---|--|------E--f
m-o--T----XXM------M-XT?-T----B---B-B--|o--X---X-B-|-o?oo-T-----M-?T-|MB--?B|-----ETT-|-|B-B--E-------?|MBB-BXE----|---M---T-----|Mo--o---B-?-MEB-?-To-?-E--B-?----------X?M------------?|--E---BT-BT-?X
XXXXXXXXXXXXXXXXXXXXXXXXXXXXXXXXXXXXXXXXXXXXXXXXXXXXXXXXXXXXXXXXXXXXXXXXXXXXXXXXXXXXXXXXXXXXXXXXXXXXXXXXXXXXXXXXXXXXXXXXXXXXXXXXXXXXXXXXXXXXXXXXXXXXXXXXXXXXXXXXXXXXXXXXXXXXXXXXXXXXXXXXXXXXXXXXXXXXXXXX
