--T-TT----|T---T----o--------?--XT---M-------TT--------X?----------------?--------X--T------E---X----B--X-------------------T--ME---T|-----?E------|T---M---T-TM----T------?T----TT--E-------X---E-T----
----||B-Mo|-?--|-T-----------?-TXT-oT-BE--B---T---------M-BB-T-X-------T--T------T-BX-----o------?-M-M------T-X----XTX-|----|--?----|T------T-Xo-X-|TX-T-T----TTB---|-------T----||---B----?-X-----|----
--E-XXT--------|TTX----T---E---T-|------?B----|-------------o--X-------|o---o---|T--X--------M----------T--BT-X-----|XB|--|---oTTB-oXT-------??-?------T-B---T||M------M--BE|--T-T-----------|-----|----
------TE-------T-|XB?--|-------|---o----TT-T--TT--E--?---------M-----B--|o---B--||-------?----?-----------|-X-X-|---|---?-|-----|---XT---?--TT----T----|-----T-|--------T------T-|T-------T-B|----TT-M--
------|-o-B---T----------------T--E-----T-------T------o-B---T--T--T----T-------||-E-o-T---E---T---T------|BX---T--E|-------TT-o|----||-----T-----TX---X----T|-X--E-o---|------T--T----------X-?E-T---E-
---------E----T-ET-------------|--?B-E-T|-oT--M---To-Xo-?--o-|--|---B---T---B--?----T----------?---|-T---X|---E-T-T-----T----T-E----o-X---T-T---X-|-M-T|----T-TX---T----TT-----|--|------M---X--?-|-----
---B--E-E----T|------T-T------M|-------|----T--E-BX--X--T----T--|B------|--B--E----E|---T-------??ET-TE---|E----|--T---||------X----------|--X---EX---TX-X--T-----oT----|--?-X-?--X---B-T--T-------|----
--|---o-----?----------|-|-----E---------------T?-X-EX--To--?|T--T-?---T-B------B-M-|--B--T--X------T----T|-EE-T-M-|--TX|-o---MX-----T?---T-----------T--|--|---M--|T-?-T--TTXT-T-X-o?B---------o--T---v
--T-----B---T--X--T-X--|E|?TT--E--------------M-------T-|--X--|-?--T---|M---T----T-T------T---------------|--T-|E--X-oT-TE-----T----T-----T----o------|ET|--XT-----o----T--T--|-T-Bo-----------T---|X|Ef
--|-------TTTo-X----X--T-|oTT-XE-----E----T--------E-?-----X--T---TT---T-?-M|T--------o-X-|---|?-------TE-|----|B-----|-TT---X|--X--TT-T--TET--T---B------T-o---TT-T----|?-|T-|-|-----TB-----?--T---T|-f
-----E---B-T|T-X--T-XM-|?|-||-X---T----XT--?-?---T---?T---|---T-|T-|---T--o-|T-T|--T----X-TT--|--------|-----TT|M---?-Xo|----XT-T-T-T|B|--|---------B----T--|---TTT|----T---TM------TM-----T----T---T--f
-T--T?-----|TT-X--T-T--TT-----T--|T--MB-T-T------|----X-X-TT-TT-|----T-|T--TTT-T|T-|T---T-|-T-T-B-|T----------X-----?--BE-T--T|-T|T-TT-|T------T--|----TTT--|-TT|TTTT-M-TT--T?T---|T|--?T--|-|--X--B|--f
-|TTT---T--TXT-TT-TT|-T|-TT-T?T--|--T-|T|TTTXT--TTT---X-XTTT|TTT|E|-TT-||ToTTT-|T|-X|TTT|T|-TT--TT|TX--TT-T--TX|-T-TXT--TT---TT-|T|T|TT||TT|--TTTTX-X--T-T--TTTT-|||||TTT-T-TT|T-T||T---T--TT|--Xo---X-f
-T|||TT-TTTTX--X|-XT|-TTT|TT-TT-||TXT-TTTXoX?|-TTT|TTX-|XT||TTT|TE|T||T|X-|||TT|||TXX|TTTTT-|TT-T|XT|TT|-----TX|-||TXTT-|TTM-||XT|||TTX||TTTT-||TTXT|T-T-TT||T|TT--X||T|TXT-TT|T-TX|T-X|X|T|||-|--TTTXTf
mXXXX||X|XX|XXXXX-XX|-|||||--||-||XX|X||XXXXXX-|||X|XX-|XXXX|||XX-X|XX||-E|XX|||X|XXXXM||||-EX--X|X|||X||-XXM|XXX|||XXXXX||X-XXX|XX|||XX||||-X||||XXX|X|-X|XXX|X-X-X-||-|X|-||||-XXX|XX|XX-XXX-|XX||M--X
XXXXXXXXXXXXXXXXXXXXXXXXXXXXXXXXXXXXXXXXXXXXXXXXXXXXXXXXXXXXXXXXXXXXXXXXXXXXXXXXXXXXXXXXXXXXXXXXXXXXXXXXXXXXXXXXXXXXXXXXXXXXXXXXXXXXXXXXXXXXXXXXXXXXXXXXXXXXXXXXXXXXXXXXXXXXXXXXXXXXXXXXXXXXXXXXXXXXXXXX
