--Mo----?--X--M------E|-|?---ET-T-T---T-BEB?oM-|-o------MBT-XM-?M--X-o-BEB--E|-----B-E--T---X---oX----EX--XM--ETT-----|--MXTE--|E-o|X-o-----X-TBM-?-ET--TXB-----o-----XTB-?X-MT---M---M-E--|--o-M-X-?BB-
-M-TME?-oX--B-|-EM---|--XE-o--|Bo-M-T-Eo--M----X--------X--T--oEo--X---E--------------?--EE--M-MBX|--X--XT--B--X-o?--??TX-B-M|MTB-|o----T-T-E------E-B----o--M--T|--T-----?-M--E--oE-|o-o----B-E----X-|-
-?--Mo-M----M---E??M-----E-?M|-----?-EE--o----o----?E-?-T-ETTX-??o-B--E-o--?o-----MXE-M--------??-Xo--o--X-M|MM-----|-T|---X-XT-----X---M-E?-BB-|X---EX-XTM--B-M-EE-M--E------X--|---E-------XEX-ooo-TB-
--o----X---------------T-|EoX--B-X--B-T-|----M---M--X-o-T-?--?ToXT---?-o|-M-----E----M-|-?--Eoo------|M-?--oTM--X-T|X--E-o--M-T-o---M-E---T--MMo-|--T-?--o----TXB-XT-oM-E-MM---Xo|-X--|T---ToX-T---ME-|-
--o--BB-||XET--o-Bo-B-X------T--oooBo?----T?X--BE-?BXE--MMooXM--E--T-|----?MBE-T-B-?T-?X----|-|BXM-X-T?---T--X|---?--B-B-oTX-?oEBE--oTBB--o-T--o-E--?X-E--oX-TX?-oB--B---|o-|T-o-o-|o-M-B------MooXT--?-
---X-EE--E--o-MEX-------X-XM-XE-E-E---|X-X|o-E-----oX---------E-------ETTo---M|-----------MB--E-oB--BTM---|-?--XXX--B--Xo---X|-B?-To----B---Eo|E----Mo-M-?--??--oB|T-XBMX|-T-M-B?-?M-----TEXT-|oMB?-TE--
----XM|Bo---X-B-oE|-?EM--B----M|X-?TEE--XM-T--E|--TM-|?---oX-|X----X---oo?-------|-----E?--?-o--B-----??T-E-o-B----X--X---T-------?-MB|BT-T-X-o--o-|To-o-----o-|---X-------oET--|-?-?Eo-----oM-TM--B----
-X-oX-E--XM-|B-?EoT-------X-E|-TX-|--o--|----ToB--M|T-?X-E-MBEXEE-EB-|?o-?--X----BB--MM-MX-|-T-XE--M--E-X-oMoX----MMo-MM-|E?o|--X?-?--E-------?X-M----M-|X-----MTM--B|?--MMo-o--?--M?-X-X--M-B-EB-B-XE?v
-?T-oT---o--o?----|EX-T-----M--EM|-EMT-X---M--E|?---E|??B?ME-B--X-----M--oo----M---X?o--MoB--X-?-----MoE--TT--oE---T-EM-BM---MM--?X--?|ME-------To-B-E---|o-----E---oB-?-B-BTB-X-M--|EM-?--TTBM----X---f
-T-?-oM------?BM-o----T|X-ME-BEoT-BB----BT--?---B?|E-E---E--o---T-E-o---|o-B-MMB----M-|X-MMEX---B--MX-M-T-XB----B-XXX-----E-X--XMEM-------B-?-?-o---B-B-X--E?-X|Xo-|TX-M-----T---TET-X----EMX---|-??-oTf
-T----TMB---?E-M-BT----TTT--T?-TT-B-TB--M----|-----T-|E--BXEXX-|-BEB-|Bo?Mo?|ET----B|---M?--T---XX----M--T-o-BoXB-X--BX?--E|?B---Bo--oE--E-XTX-X-B--Bo--B--B-ooE--E-X?---|-----T------M-|--|oo--B--BE?-f
------|-ET-MM?--oT-|oEX----M----E--?----o|T-XB-BM--|--EBMT-----|X-B?-E|?X?o-----BT----M--E-E------T|ETX-XT|?---TX--B-?oE-E|-o--T--M---Eo------oM?---?-----EB??MB-E-o-E-T--T--T-E--ET---oBB?-|B--------Xf
-o-B--B-o-?--o-----|--?E--------BM-|------|--XX----B-o--o------o--XB-M|---|XB---oo-------B-TX?-XXo--BM--?-?M-MEX---?-|-M-?--E----M---T|B--EBT----?M---?---X--B---MX-X-----B?-o--B--XM?BE---T-ToM?|X----f
--?E---?-X-------B--M---ME-o--BX---XEE--XB-B|---M-?-o----|-----B-T--o--X-oB-|?------?-------M-M-M------?-Xo?--TE-X------MT-o----o---T--|---?--XoM|MX------E-|X|T-?-?-M|---o----M|EMBE-TX|--o-TX-------Mf
m?E----?X-|T-|--|M-Mo-o--X-?------EX--oX--?oTT--E----MX-M---E--?BB-o--|?-E-ET--Bo-TB---------X-B--M-X---E----------BE|E-EXX|T-E---B-X|---T--TM-T-X---XT-o-X--T--M-o-?--o----?-X----E-M-B--oT--o-o-M---TX
XXXXXXXXXXXXXXXXXXXXXXXXXXXXXXXXXXXXXXXXXXXXXXXXXXXXXXXXXXXXXXXXXXXXXXXXXXXXXXXXXXXXXXXXXXXXXXXXXXXXXXXXXXXXXXXXXXXXXXXXXXXXXXXXXXXXXXXXXXXXXXXXXXXXXXXXXXXXXXXXXXXXXXXXXXXXXXXXXXXXXXXXXXXXXXXXXXXXXXXX
