----------XB-E-o----B-X--XE-ME-B-----oM?-|o---?BE-XE-T--|---XX-TE--E---|------?BX--BMo-ET--|-T------o|-----oX-----oMB-?B---?---o---?-M---?X--M--T?o---M--E|-XB-E--B----|X--o|M-TB--|---MM--o-TT-BoX-?---
----X-|-------------TT---EM-M------BMoME----T-o-T--MM-E-E------?--E-XB-X--?B?B-----??M--E--X------EM-------M|-T|Eo-o|BME----E---|T|-MX|TET--EX---BE-ET-M-----M-o-T-T-o--o-B-EB--o-T-?--o?-oX-?T---||--|-
----o-M--?E-?----E-?-?M-oT|--X?-|E?-------TMEMo-T--MEET--M|X-E--?-----X--X?--|-?-?----M----T-------o-|B----oM?X---E-X--|M-M---X----T----?---E--|--o|--|TM|M?-M-o-B------?-X---BT|?-----ETE-BMBE-o--T----
-|T-o--X--?B-T----|-o---XB-T--ET?-X---X-M-------?B-T?-?-E-M-?--||-ETBB--|-B-E|E---|o?B-XT-EXT-------B-o----E---o-X|?----M|--EX-----|----B---M--E-?-?E----?T--X--?-oB|--E--?-T-XoB---TT-||--B---E--------
-X--MM?---?-X---E-o-TT--T--MT--ME---|-?Bo|--T----||-T----BBB-?-E----|T-M-X--?----B?|BT---|MB--M----T?o----|--X------Bo----Mo--|--X-o--ETX|--|-B-?|--------B|--|T---M-?XT----BMXB-M|--|Mo---MX---------E-
---BE-X---B-----X---X---|------o?|M---TM-M--TXo-To-----oEE--E?-oT--------T-M-X-|E----T-----|-B--X-?TT--o----X-X-o-o|E---?-|T-E-B-E--E-?--XT--?-oX---|----oo|--EE|--||-----T----TEXo--------M-EMT|---X---
---?T-BB--oTE----B------o?----|--E-T-o-X-Eo-oE-----|M-?-ME|--TM------------TM--E---MX-----B?o-----M-T--E----T--E---BEo?-?-o|--oEX---XT-|TX?-BE---E|-TX----?---XoX|-?-------B-XM--M--------o-B-T-BB-?T---
-M---M---B----oB-|M-E--T-XB|?--X?-E--|-----M--o---?M-X-----|-X-?-?--Eo--TE-E---|---E--T?BMB-?-To----BT-o-XE---MX?M-----E-X---E?-?o--MT?--|--E-M----M||E--??-B?-o-B?--B-o---|-T-X|-B--|-o-o----|-T---B-|v
-?|-T-|-o--o?-M-o--?-EB----?o-o-|-|E?--|---------E---oM--X-BXXE--oT-T-EB?--o?----|E---|TT|E?-?-ME--T?M--o-TTTBE---?-?---oE|--|B-|o----XX---o-?o-|---BX----XM--|-oBT-M------|--|-?--oM---B-?X|X?-T-Mo-X-f
-MT-o--|---E-B|--E--B--EX-T----M--B?--ME-?X-?-?X-----o-X-o--?---|-?-|-M---B--B---T-o--o|oM--o?-B--oMoT?-XM-XTBBMM-E-?||-B|--?--MM-|----oX|T-EE-----------|B|--M-?-oEM-M--MT-X-E--|o-T-|o--T-?--B-E?-X-Bf
------ooT--?EM-Bo-TM---T|-?TXTMM--B--E--XM|M--M-E-B---?T-o--------------X---EB-Mo-o---EX----E-|-|o--?X|----o---X-----EX--E|-MMXXoX-?------EMM-------|-B-TBTX----B-?-M-MoB?oX--oEBM---?---XTT---XT?-X--?f
-X-E-E--M|?|-X---o-?-M-B--X--X?T-|-|---|X--|XB-|?--E?--T----|--B?-X--?M--?-XBT-?--|-M-?MTEB?----oo-M-----E------E-ME-oB------T---?-oB-?-X-T----X|--------------M|-----B-T?----X-----X--BX-?-TM-?-MM--B-f
-B---|-oTB--?-|||o|--MMo|-E-XM--o??--o-E--|-X----?o-------T-----T-M----Xo--TBM-??EMB|---------B-o|-E?----TX-oo-----ET|B-B-o|--o---M?--EB-TEXT--T----?|-MXX-B---B----B-TT---oE--|o-------Xo----M-M--o-MBf
-|o------T--T-|-?-----MXEo---T-||-M-XE--B--oM?---oXT|BE?------T-Mo?-|T---MET-EM-|M-T--|T-?-|----T-o---T--|?oTX-|--?X?-?T--?--Bo----B-X--oEBT--X-|-M--B-|-|--M-XB--o----oT--B-B-X-----Bo|BM-XoM-----X--|f
moM--ET--XXT--|-X-BMEMB----B-BMo-|M-------M-T--?--X--M-|X-------|EB---B-X--?--Bo---X--M-ETBM----?--X------|M|B|---ET-TM-X?M-?-B-?-o?X-------B-B-M-BT-BT----T-?-E-o-Mo-X----T??B-?XM--B?M-----|-E--M-BE-X
XXXXXXXXXXXXXXXXXXXXXXXXXXXXXXXXXXXXXXXXXXXXXXXXXXXXXXXXXXXXXXXXXXXXXXXXXXXXXXXXXXXXXXXXXXXXXXXXXXXXXXXXXXXXXXXXXXXXXXXXXXXXXXXXXXXXXXXXXXXXXXXXXXXXXXXXXXXXXXXXXXXXXXXXXXXXXXXXXXXXXXXXXXXXXXXXXXXXXXXX
