-E---ME-E-E--o-M--|X-ME|M?EM-?-?--?Eo-----B-X--XE-?-XE|-?E--M----o--oT-X--E---B-X--X?X-o-BoXE-MX--?B?|TB--MTM-B----|--T--X?-?-o-MT-T|---o?---o----TT-oooT---|-|--B-?|TX-B--o--M?-|-?BXo-?-B-ooB--?-?----
-X--|--?|----E-E|o??|--MX-Eo-Eo-----|X|-?-TB-E?-oE|------o---E-B--|M--?-TM-?--M|B--X--X-E?--BM?|-o--EM-B-B-|-X---ET----T-?-oME---M--Bo-|T-To-oE?-?----?--o---|--MT-To--------Xo-T-Xo|?M-----M|o--T--M---
-BT-o-E---X-|-oT-M|--|M-o-M-T-B|XEo---B--E---o-X----X--B---E?------BT-TMo--T?--T-?|--X---Too-oE-To----??--B-T-o--|-MBBE--B--o---E-o-?--T----o|B-X--XTXB-B----T-T-BTX|EM-M-----BToo-|TT|ME--?o--B?-T---?-
-M-EoB--X---oo---o-E-----ooX-X------BTT-B--BX-----|oT-oo?-|M------o|M---|--XB|EB---X-E-o?--o-EB-XX-------M-|B--?--X-o---X---M-------X-|Mo|EB---M-M-ET?-E-XTTB-T-?-o-XBX--|-MXT-o-?oo-E---T-M||-o-T-T----
-T?|-BMMXE-X-T-ME-MT-BoM-X?-XB---E-T----B----oo---o-X-??M-B-----X?--B-----B-X-M----------M-T?------ET----E--TE?X--o----X-||T?-BE---?-|-Eo?---BMXX-o-TEM--TB-TM|-B--o---T--TBoo----E--M------T-T-T--T?E--
---T----?-X-M-----oo?--Mo--T-EEXB-EEM--o----?--T--o-o-?T---M-o|-|--oo?--?M-M--TX------TBX|E-|-X----T-E?B---M-|---|T|BME--XE-?X--M-TM-T---X-EBoXTT|B-----|X---ET-|------T---o-Mo--?|--E-X---|oE-?-----|--
----Bo||T---?-To-M?B||ET----T-T----EM--M?-|-B-E---o|----E?-X-----XB?--|o--?------B-|oo?--MB-BT|TB-----T--?-T---X?--|-o-E-?----TM|--T--X-|X-?---?-E------T|E--?TT??BB?------|--MB----ME--------|---o|M---
-X-MT-|X??M--?--ooE-----E-|-M-X---oE-EX------o---Mo------------|XM---|-o-Eo-|X--X---M-o?M?-E-?E-X------M?---T--E|To----ME?XT?-E|----oB----?M-o-EE-----Eo--EB---|X---T-X?-BE-?----E-o|?-o-BBT--o-?---|-Xv
----T-M-E--B?E|E--|T|--E-T--|--E-o------o??-T|TX--------X?--E------BEXE-B?--|--|XT-T-T-BX?-X-----X--?--M-----?--BT-M---MTT|---?M|--|E-TB--BT-?Moo--o--o---X--|-EM-XM-----?-B--BT---?M----T-E|--|o---BX|f
--ooo-|------EXEXE|B-BTo--||M?BX---MT--?--|o--?-|E---?-------|--XT-|-----?M---?EE-XXMMM-X-|----TEoX----MT--E------B?---M||-o-E----M?|--E---E--|TMB-X-B--|-?-X--M-----o-B|--X----?-?-|-XXX-TT|--|---oBE-f
---MB--X---|----B-o-XEM-|oo-X---Bo---?---MX--E-T---?BM-TXE--BX||-M|--||-?|-----oBE|-?TT-M--o---T-------o----BB?-----X----MT-o-?ooBBET-M-|--|E----B---X--|M----------M-TB-|------X-T?-|BoT-X-|XB------X-f
-oX-TTE|?--o-o-T--?B--oT?-|E--TE--o---?--o-|EM----XMM?E-T-M----E--XX----?--T--|M|--M---o-|---?-|----oE-XEo--EXXX?T--Bo-B-oXXT-|-o-ET---M--oB--X----MT--ME--E-X-X--Xoo-BoM|?---X|-o--o--?-T---MTB--TXB--f
--M----?-E-----oB--M???-M-BX-|---BXoB?ET|-XX--B---XEB-XXX--X|-----??B--?T?--B----|MX--XXMT-E-|E-X|-B---MXo-M---X--E-?-MoB--oo----M--X----E-?-oo-T-?M---oo-B?--oXB----Eo--T-X-M-----E-oE|--?--XBT----X-Bf
--B-E-----E----B---To--X-XXo--------XT|--oTBX-|BX---o--EoEo--?|oX|--X-oo-?----|---X?M-BM|oXo-B-|M----M------EE?||E|TT---oo--E---M-T?BT----oMoT|T-?--E-----B?T-----T-|E----X-E---X-EE-Boo|TB--?-?BE-----f
m-ETE-|E------o-----X----TE-|T---M?E-X?EToEB|?---|-o--|--------?B---M------E?----EM?--X--TB--M-X--B----M--To-E|-B--?-EMT-XM--B--ME---B-o-------EEoMT-o--Mo-EX-o?-?--o?--------E-----Eo--X|ME-B----oo---X
XXXXXXXXXXXXXXXXXXXXXXXXXXXXXXXXXXXXXXXXXXXXXXXXXXXXXXXXXXXXXXXXXXXXXXXXXXXXXXXXXXXXXXXXXXXXXXXXXXXXXXXXXXXXXXXXXXXXXXXXXXXXXXXXXXXXXXXXXXXXXXXXXXXXXXXXXXXXXXXXXXXXXXXXXXXXXXXXXXXXXXXXXXXXXXXXXXXXXXXX
