---X-----T?X-M-|?-EE---X-E-X-B---o---M|-TE---------E-BE|---M------o--o-|X--?B|---------X-|-X------T---o-|-T-X-M-|-|-MXT--??--Mo--o?-M---E-ET--------------B--E--o--?E-----EX--------?-TBX----ME|X?E---?-
-B---M-E-X--M-B-E-EE-?-E-----|?-o--M----?----B?---M-M--E-Mo---?--MX---------?-X----T-|-E--------?--X-o?T-|--|-T|T--?EX--------M----|T----?-------|------B-BB|-MBoBEo--M---|TM----BT---E-o?--M|?--B----B-
--o-|o-X--B-XB----MT-X---------E------B-E------B-o--?--TB----B-----?--M----T-X-----X-E-?--------B-|B--MB--X--B--?-|----TT----|-?-------X-----B?MB??-----X--B-B-?E-T---BTM-o-E--oB-X---M--o?X-T---|--o??-
--?B--XX--?--E--T---X--o--B-T-X-o----E--|-MEXE--M-?E|E---MTTo|T-T-o-T-M-MEB-o----M---M-?-|TM----|--||--|---------?---B--B-T-?-E-----?-BE-XX--M----B----|---X-|B-XTo----|-B------X---|-B---E-T----?-o--M-
--EEXB|------o---E---M-----XM-----?-?----E--E--?X-------B--X|-E-B?--B?EX-Eo?--T-M-|EX-BMo-T----B-E----M-o---oM------E-o-|X------------M----o--------X----?----?------E---MT--|---E---?-?--E?------|X-BB-
---?--T-|--o------oET--||-----M---E-MT------X|-BB-o??-|EX-T-?-XoE|---|--------|?--o----?--|----Eo--o----|--X-M--M--|BE-oo?-------B-TM-o---X?X-o--?-M|-|-E-E----------BE-----------|Eo--?----X--|--------
-----X--EEo?-----------------|---|--M-o------X|T-|----M-B-X-?--------|-|---------M-?o---X------|XBTE----|-E-?----|-----|--?---B|--EMX-------------oXoM--------X-------M----?---BE|-----BM?-M----XB----|-
-?--------B----E-|BMBo------EE---X--T----------T--XT|T--B--?oT-X--B-------------|oo--o-o--------B--|-?--XMo-----|EM---?--X?-----B---B-------|--MX-X-B---M-?----------?M-BB-E-E?Eo--|B---T?-E-|-o-X-----v
-oBTB-T|-M-oX-X-T-----o?----?--M--------o--?-B-E----------XT-|-------E-----o---Eo|-|-XX---XM---T-o---Mo-T|o---||-?-----T-?-?--T--------Xo---T-?B----BB----M----B--X-E---M----------XXX----------o---XoEf
-B|---X-X-o-o--M-oX-E-XM------o----MTo-o----?B--o--------X--T---o----------oo-E--?-o----oE---?----X-M?T?-o-ToB--|-M---?o??-oB--?---E|----------BB?EX---??|--?--E?o---|B-----ETo---T---??--o---T--B---M|f
-?B----|--|--?|-X------E?o--?o-BEB---M------XT--o---?--------T-MB--|--B-?B-T?-E--oT|?E-?--||-XX-?-o---M----E--M-----X-B-|T----E--o------X-|T-?|EE-?E?-----M-X---o-B-|-o-oB-X--TX--------?-TX---|-E--?--f
---E--|E-----X-E-M----B-o--|X-oM|B|B-BMoM--E----?------|-BoTo---?--oT-----T--o-----|B|--B--o--XX--|-o----E-?--------B-------M-T-----M--To-o---|---XX-B-MM|X-|-------MM--|--M----MMT-B---|--oT-o-------|f
--B-B|-|T-|---?----|----T-E-XM--X---o---T-|--|---X----T--BM?--M--E-M-oB--X-MT--||--M--E---|--E-----|-E--|---X------X-|X-T-B|--XE-T||---------B-B--|TB-?E---|--M-|B----|?B---B---T?------?-EM-B----o----f
--BX--|-------B----X|-ME------B--T-|-E----|-E----------oB?TT---B?BB--E---M----B--?-X--|TX?X-|--oT|X---B---M------E-X---o-?-----o---T--E-TX-T|?-?-?BB---TXoB-o----B-o?oB----?-EM--T-?---E?-|-M-X--X--?--f
m----M-M-oM--ME------X---?o--o--?---E--T-T--T-?E--?M--X--?ET-T--------|--B--B-------X-TM-o|-?XX--E-?-M--TX-?-?--T---|-oT--o|-----|B-T-X-T---TT--X--|-T|-E--o----|---M-o-E----E----------?o-Bo---E---MB-X
XXXXXXXXXXXXXXXXXXXXXXXXXXXXXXXXXXXXXXXXXXXXXXXXXXXXXXXXXXXXXXXXXXXXXXXXXXXXXXXXXXXXXXXXXXXXXXXXXXXXXXXXXXXXXXXXXXXXXXXXXXXXXXXXXXXXXXXXXXXXXXXXXXXXXXXXXXXXXXXXXXXXXXXXXXXXXXXXXXXXXXXXXXXXXXXXXXXXXXXX
