---B---o-XTX-M-B---X|--EETT-oBB?T|XB----?E?|-??--EX-|---?TMX--|E---E-TEBM--M?----oM-|BM------E----o-B-T?-o---E-BM-XTo----|--BE--XM-M-o?--ET-----B---|M-?--?-E--T?M??-X---|B---MoM-XX-oEEoM--M-BBTBo-E---
-----Bo-T-o-M--M--|-E-------M-|---B-M-T|TM--X-T---o-??B-------M--|--|---?o-MB-X-----To--XoX-|-B-|-MoX--B---TB-?-----M?B|?-BM-T------MEB----X--o----XB--T|----E-?--|E--BXB-|-M-|?|-M----------MT-|T-|-MM-
-oEEM-|----|---oM--ETE?-XXE-B?-T-?-----------T-o----o|-M-B-X--M----|-Xo-EX--??-------oXE-oBX-BT-oE--|-EE---?B----TX----E-BB-o--?-X-X?-|o---ME-X---o----TX-----T--BX-o--B-?-ToMMB--|o?--E-X?---?|B--|o-B-
-EXoBMo|-B-XBB-M-EM----M-----E?E-M---E----B?-|?---XB-?E--X-|o-X---|---X?|-----MT|-?-?-oMoT--E---XBB-T-XXo--BE---M---X-XT--M-oEEM-?-T---|M--oM-M----T|----M--E--E-?----EB-X--------X?---E--o|MT-|-o-B?---
--------TM--|o--oB-X-o?B-EBXo?-|-X-ETXBo-B---TTB|----?T--T---B-MB?T---BT-MET??------o--BX-TMTT-o----B-oMT--XM--|----EXXE-T----B-|-|?-o-oB|-oX-----|oX-??-----|-----?-M--B---E-|o---BB-T|-B-o?-B--BE---B-
-B-o-E-----E--M-MoBE-oE-o----------?M|T?-?-EX-----B-|---Bo?T-B---B|EE-E------|----X---|E??XM-MX----XE|---T---BE-o----EXo|X-?X??----|B-------|o---oo----?|-o?B----E-X-X------T-X---TXEo-E?--?-o-?T--|TT?-
---?-----X----T|-oE-|M-T||--EMM-E----M-E-?-B-T-??--X-M--MXo--B-o-|--XE|--E?-XX-XE-T-----?-?T-B--E--o-?-?----T-o-----T|---T-BX-B?-?-|EMB------T-X-o|T--oMTTE|-BM--T---T--------X--o-o-EXM----T--TE?M--T--
--X-XT|o-To-T--oB-XB-X?TXXM-XoE?-TM?-||?o------E-M?--??------M-?--o--|---T-TEMoT-T--|--B--EM----|X-BM--M-B-B-||?---B-o--T---?-------B-o----X--T------E---TXB-?-X-|?-B-|-?-M---|--?X-M-?----EX----X|--?Xv
-B---M--B-M-E------o-TM--TB--o--??-|M-M--|||MM-?------TToT--|-MT?--|------oB--E--|BT|----B-----E---T-MB--T|---BoB---EEB--|X--------|M-|MM--BoB--?----BE-----?-|T-X-X--|X--|-E--MX-o|-TE----o??------|--f
-E--EE------?MM-?-X-M--|-X--?M--X|--|----BTB---TB--?T--?-|-M-----XBBTE---o?B-B-BB-B-X-MXTT|--oo?T------EXT-XX-------E??----|T--XEXE-M-------M-TE----T-o-BM-B---------B-|-o--B-|---|-E??XE-B----?--T-|--f
--?oo-o|M|E-XBo--------?------B-B-B------------EXEB-B--?-o--|oBME---X------|XME------M-MB---M-|----MM----------T-M?----M-EX-|-oEo-XM----BB--B--?-XM-BB-B---X-oT------|E---X-o------B-EX-B--------M-----f
-?---M-------EB-o|-T--?----oB-T-|-|-oTX--X-X--X-Bo-|-TT?E-ME?-TXEB-B------|-|EM--MTX-XB||--------X--X---M|B--T----M---|-|-B-|-o-M-X-M-----T-----|-|B---o-T-?X-XM-E------|--XBB-EBB----?o----X--B?M-----f
-|--X-?----|-M-BM---M-o--?---B-X-|----BM-oMT--oE--M--M-?BEo?--X|MB---|M-|-TT-T-----TB--T--X-oBEX-XE-----B-B-|Mo|E-X-E|----------|MB-||--Xo--X-?-o?---T-E--Bo-T-TB---?-----T---E|-?--|-X|-TM-|T-----B-EMf
--XB-ET-TM-E--?--T--?-M-?-To?----o?-T-X-|-oM|-MXTT------B--?T-MT-T--B--o-B-Xo|-XE?E---o--|E---?B?X-M-E-?---?Eo-o----E-X-BET---M?M----X-ME---------E-o----BXX-|-|E-?------E-B-|--BE-T-oX-M-o-oT?--M-----f
m--M?-|--Bo--?-BT-|XB-?---|------X-?---E--o--XX--X----?||-o----ET-M--BE-T|-T-TT-o-E----X--T?-E-?T--B-|-o-T-o-----M----T--E-M?-M-|X--|-TEET-T---------oE---T-E-o---M|M--T-E--XE--|M?-B-oX?-------|TE|--BX
XXXXXXXXXXXXXXXXXXXXXXXXXXXXXXXXXXXXXXXXXXXXXXXXXXXXXXXXXXXXXXXXXXXXXXXXXXXXXXXXXXXXXXXXXXXXXXXXXXXXXXXXXXXXXXXXXXXXXXXXXXXXXXXXXXXXXXXXXXXXXXXXXXXXXXXXXXXXXXXXXXXXXXXXXXXXXXXXXXXXXXXXXXXXXXXXXXXXXXXX
