---|--|?X--T-B--M-XM--B---o-M|-----X-X-|-----B----X----XBo--Mo--MT-TBB-B--------E-E---M-o-----E---o?---oME-X---?-X|-?----XT|--M-T|-X---o---?X--T-Bo|-MM---o---?BE----E|-?BM--M---EM---B-T-o-|--|o--o|-|-
-?o---M-----X-oT--X--M|T--|T--TETE-o--EooX-T|-M--M-?EXE-T?EM------|T-X-TXX--|-X--E--T--??-E---X|MX-----XM?E---T-|T-|-?B-X-----XB--M--X-----|-----E---|-|BB---M--ET-EoM???--E-BB---M-XM-EE--E--o-X---X---
-EX--ET-T----|--E--oB?-?--E--|o|-X----E---BE-|---E--XB?-?E--|--T-X-BEM-|B----T-BooX|-?-oEo----M??E?---X--EB-X-B----MB---o?---EB------XM-B-TMXo--T?--E--Eo----|---B-XE--o|?-E-M-MM-------?--|B--T-MB--T|-
-T------M|-M--------o--M-----T---T-B--?-M--|----T-M|--T-------o--o--TT-T-T-o-|?------B--E--|-B--T-?--B-X-B----B----B|--|E--|T-|---E-------BX---X-TMo--|T|?--E?-?M---T-E--o--MX----T|-T----?-B--E--||X---
-o---?-E---XM-EEooo-------BX-o--E?---B--?EB||o----||--o-T--X----TM-XoB-----T-o-T?E--TX-|B--?---B-----|---B--M------?Mo--BM--XXo--BB---BBo|----BMo--T?----XT-T?EoBE-M--B-X----|oBo-----|BX---o-o--BM-M-?-
-oBo--|---X--?---XB-------TM-EX?E----EM---M-o-oTT-X?X--o?--Mo--|?--TBMM---o---X-E-----?-EE-o---?-|?--|--?-X-|---oMM--E---|X-B-o|o-||-XT--BBX--X--E-o---o?----B-M-T------|X-o?-??-----XE-M?X-Eo-------EE-
---E|M---------X-----|-B----B---E-oo---|?-B--T---M-M?T-Eo---M---?-T-|?---E-ETB--M--X-|B-|---o-BMBo-?|-o-M-|-M-B-EEoM---X----B|-o--||--|--?-M?-------|-|--X-oB-B-XBE-?M----||ooE|o-XM----------?-MX----X-
-o--T--?EX-XM-o-|-------M-XM--?XXB|--TX|-E---B-?E----o----B--X-BXM-M?o-o--oX-|?B---X-------B----B--Xo---B-E-M-X-------MM-XEMMB-?|---||---B-oBo-E------?------?-?M--oM--------B----X-|-X-o---B--B--MM-X-v
-----|-?T-M---|--?---M-M---?--|----?|?-MM|-E-E|XT-X--BE?E-|-M--EBBT|-X|-X--B-X-MT--o--E?oo-B-?-E?|X-?BE--XoME-oBM----|-X--M--To-|-----|--X-B-X-TB-MT?--|-E-|?-|----X-o----X------?----X-oo-?-E-?M|o|E--f
-?-XETM---M--|-oT-----E---B--B-----T---TX---T-o-|--X-|----T--B----XB-M?XX---oo-MB---?--M-?-BX--o----?----E--TMB?-BT---M----o-T-XB--M-------|-TT-T-T-----|-To-X-o--|-T-M---|-TX--X----|BE--?ME|oMEo----Ef
-o-B--M-----TBT----?Xo-T-T-T?|-BM---o--X--MM-M----MTEX------EMM|B---TM-X?------MM-|-BBo----B|???|-----X--|--T----M|M|-X|XT-------|--BE--T|oXB----T------T?--?o?-M---EoB---MB---EX|----|E-|-B??|B-B---o-f
-M--E--T---------M-?--X-------|BoB--XB|-----o-EEX-------o-BT--B----Eo|--EE---T?--T---T-----X--|T---oT-EB-E---TM--?M--T|M|E-X------oM-M-EMB---o--E-B-|-?X--E-MB-To|---B-?-E--X---EB-----TE-E-M--TM-BB---f
-B-T-?B--oT-oT--B--BB-oM-o?-o----oB-TE--|B|-T-To|--|o?---|-?--|----BE-o-------TTT?-||------o-TMMX---T-Mo-Xo---|---X--X---XT--T?E-T-|-B---B-|o------BM---MM-----?-------XEoBo----o|-T--?---?-BMT|MB?-o-Bf
--EE?----E----M---M--|MBE-oX-------T-M-M-B--T---B?---EB--?M?----|--o|XB-B---ME--o--XT-T--Bo------|----E|-T---T---TT|--T-M--|X---ETE-?o---BTX-B--?--Eo---E----------MXM|-----ME-XEM-To-E-B--M--MMX--|---f
m------o--TT-?-?T---B-|--T-o|T?-T---TX-|-E-XE-?--|-X--XB---BE----TE-|?-Mo?-X-?o-B-oM?---|-X-TE?------?TM--?MT|oM-o-E-???-M|B----BX-o---M--MB?--|--B--|-M|?--X--|?--M|o---X--?oM--BT-M---T?oEo?--X|BT--oX
XXXXXXXXXXXXXXXXXXXXXXXXXXXXXXXXXXXXXXXXXXXXXXXXXXXXXXXXXXXXXXXXXXXXXXXXXXXXXXXXXXXXXXXXXXXXXXXXXXXXXXXXXXXXXXXXXXXXXXXXXXXXXXXXXXXXXXXXXXXXXXXXXXXXXXXXXXXXXXXXXXXXXXXXXXXXXXXXXXXXXXXXXXXXXXXXXXXXXXXX
