-MX-EXT----M-------o--B|-----?-------|--TTBT-|X----BM---B?o|-M-MEX--T?-T|B-oT-M-o?X-T-T-T-?BX--Eo--oT??--|-|-B---|T--B------XEX-E|-----E----M-E-MB--B-M-?EX-T?-o---Xo|EM----o-|-M-X-?-B|X---X----T--?o--
-o-oT---T-|T?--|-B-TXMEE--B-XTo----B-B--M?-o--X--X--BM-T?o--?M----TEB-?o----X|-EE-----|-BTo---B-??o-?-----T?TT---?---MM--Mo---M-?To-X---B--oTo---BoMTB----T----M--?---X--X-oM?------X-X-EBB-E-----o---o-
--T--EB-oBB-----X----X-M-MM--o-MT----T-T|---X?BMB-X--T---||----T-----o---TX-|M-X------o--T|E?-Xo----EM--?----oT---X?----B-T-o-B----ooT-MB||-E-M---M-M----X-X-----?-XE-o-X-E-o-T-?---o-E-E-X?----X?---EM-
---?-o--EMo|--T-M--MX-o-?M-?-B-|B---X|o-E?---T--MB----T|--?T---EB-|-EEoEo|TM|B-MM--EBM?E---o--TT-ET------oE|-|-M|------?--X--B----Xo----TE---|----E--?----oM--o-M-|----MoE--B|--E----X---------?XBMXM-X-
----o--------XBBo---TM-|-|--o----oo--XT-M??----X--|---oM|--?X-B-|?-||-E--||-----B----o-X|MB-T-----X-M---o--M??-----M---B-B?EE----?--||?MMEEo-EX-E---ETo|-E|-Xo--E?--o--BEE-To-T----BX--X-Mo??-BXBM-o|M--
---T-B-B|-B?--BB-----?--oE-M--B-?----?-MB?oT-M||BE-EBEoB----E--B---?|--M---|?-BE--X--?---------X?-------|-T--?---EXM--X|-TE?--E----|-?-XBEo-M-o-X|MB----MX?BT-MM----EM--ME-M---?X--MM-BB-TTXo--oo--M?E|-
-----XE-|T---Eo--T-E--E----|--o--T-|X--M---TE-B----E-|----T|oE-?o-TEX--E|-oT--M--EM|MoBBM-------TTE-EoE--E-X--E---oo-T----E|-M-|MBBM-X--M-XB|-?--o----||-T---|B-MB--|T--|?MT-----o-T??TToX-E-|-TTB--?---
-EX--BBEB-----B---|T|-oooX---o--BEB---M---EBT---------B-E---T-EB-B---M---?-X|-?MT---?|o-T--M?-M-X-o-------B----?|----XT----E|o|--To-E-E-??-?T--BTX--?-----MXB?-EX-Mo--B||oM|---Xo-BBT--?E|-?oBXB-M---Xov
--EX---T|MB-ME--T-------o---Mo-TX---TME----B---T--?B-||-T---EX-M---Bo-B---?---X-||T-B--|-T-o-----o----T-X-|-TBB--?TEB-----TM--?-BX|-BTMM-XXo-?E-BB---|------MX------|T-MB--T--?-Xo||-X-o---E-T-?B-EM-oMf
---o-oXoToXEE--o--?--E---E--M---X-X---BoM-E--XEMB-|?-?X--B|EToX?-----X?T-?|---X-E-E--T-B----?--?--X-?T--|-T-----o-o---TTB?--|-o--o--------o-||T-----EB?||-EEoM---T-o-T-M?-T-?XB----M---?-|X--B-E-----o-f
--||--E-T-E-X-|EEo----E---E-EB-|--TXo-EM?ET?-T-EoMB-----B-T|-M-B--BT-MXXB|?-oT|--|---M-X-----T|-ET?-|-o-?-?ETTE|---E|--B--E--E?M|?--?X-TX--B-----BX--T?-o---EXM--M---T-M---BB---?|-----BE--------TE-T-of
-?X|?-ME--B-----BX-----E?o----T----?T-?-T-|---o---XM-?---oBXTo---B--|--BM---M?|-E-MB-oEX-|--BXXM-o---MBEXB-?-M-|?E--------o--?-TT-T-----EE-o--TM-XBM--T----Xo--X---?|-TBE---E?M-|---X-B-||B-X-BX?-XE--?f
-EM-----X|?-X----ET|BE-M--oMTB---?E-?o----|---MoB?-MXX|oM---E-oB---T--oXX-o|-T--oo--||E?-Bo-B------T-TB--EE--|-X-o-----B-M-o?B|---?B--E--E---EE--E--o-B|E|EM-?BBo-?-M|M--------o--XM-XBT-T---o--------Bf
-?---|B-o?--X--M-T-?-T-TTME-?---X?Eo--BM-E-ME-MB-||?----MM|T--B---o-|-E------B-MMM|M---T-Eo---||E--|----o------T-X-TXBE?----X?X--||oB|----M--M|-o-T---M--?EEBoo-X---Eoo----EB------X-X--?---E----|?-?-Mf
m--M---X|oX---M--EB-o--?-?--oMoo-?B-B-X---E----M------Xo-E-|oT?T-|-||--X--|BET?-X-o-oT-ME---E-M-----?--X-o----EBB??-T|---?-BB----MT?T-TE|-XEE---T-X--T?-oo?--E--E-X----B--BM|-----M---X---o--o-M----T--X
XXXXXXXXXXXXXXXXXXXXXXXXXXXXXXXXXXXXXXXXXXXXXXXXXXXXXXXXXXXXXXXXXXXXXXXXXXXXXXXXXXXXXXXXXXXXXXXXXXXXXXXXXXXXXXXXXXXXXXXXXXXXXXXXXXXXXXXXXXXXXXXXXXXXXXXXXXXXXXXXXXXXXXXXXXXXXXXXXXXXXXXXXXXXXXXXXXXXXXXX
