---------o-------T-------BT--------T------TB---------T-------T---------------------T---T-------T---ET-------------B|------E---T--------M-T-----o-------B-X-----------------o--------T-To-------M--------
-------o--T------|----------T------T-MB|--T---TX----T|-------T----T----E|-E|---M-M-T-TT--------|----|?---------E---|----------------B----TT-|o-T--?T---o--------E-E-B--T------------T-T---?-----MMX-----
---B---E--|To----X------XM--|--T|-T|---|--|---T--------------T--M--B---T|--T-----?---T|M-------X---o------T------oT|---------------------|--|----------------E----o---T-------|?---B|---------T---X-----
-----E-----T---?---EET--X---|--|T-||M?-T------|-B------------|--------oT|--TTB-----X-|--------------------To------T----X----------T-----o---TM--------T--T--E----T--o-------|-|-------X-------T----|----
------T-M--|---T-E---|-T----X--||-T----|----T-------o------------------T|--|T-------------T-T-------------|E----BT|E---X------T-o-----------|--------------------T----------|-|------T----X---T--TT|----
--------T--X------X--T-|--T----|X-T---------X-?----------------|-------|X--X|--------T----|-TTMT-------T--X----o--T-----------T-----T-------------T---------M----|----E-------|---------B-X---|T-|-|----
-?--E------T-----XX--|-?-------T--|--?-----?XT-?------------T--|-------TX-----------M|T---T-|T----------T-X-------|-----M------------T--T----T--------------------T--------------------------?X--|-|-T--
-----------T?-B-M--------------TE-|--|--T----T--------?-----T--T--------B------------X|---|--T----E-----T----M------E---B-----------M--------T------------T-----E-T--T-T----------------T--|-T---T---T-v
--?-------E|T-T--TT-T-------E--|-----X--T----|--T-T-----T---|--T---|--------------o---T---T--|--B-------T--oT---------------------?----T-----T------------T-------|--T-|B-o-T---E---M---T--|-T---|---|-f
-----------X|-T----|B----T-------E--TXT-T-------|-------------M|---|--E-------------B-|---T|----------T-|---T-|-----------B-MT---------T?-T--|---o--------|-?-----XB-T---T--|-T---T-?---|--|-|---------f
-T-T-T------|-|E---X--o--T----B-T-?-----|-TT----X-|---------TT-|---XT--TT?---T---T--?B---T|T-T----T---ToT---|-|T--o-B----X-----E-----M-|--------M--o?----------------|--EX----T---T----TT-----|-------Tf
-|-|-|--EB--T-T--TTX-----T------T--T-T--T-T|---T--|TT-B-----X|-|----T--|-----T-T-|--T--T-T||-T-M--TE--|-T---|-|TT|--TT----T-----T--T----T------M----------?--M?--|-------X---|||--T---T|T-----||--|-TT|f
-|T|-T----TXT-T--TT|---|T|-T---T|T-XTTE-TT|-T|T|T-TT|T-X|--T||---TT-TT-|T-|--T---|--T--|-||-T|TTETT----T|T|-X-T|T||XT|----TTT|-||T-||-T-|TTE--X---TT-|-|T-TXT----TTT---T-|T-T|T|TT|T-TTT|T----T|--|T|TTf
-T||T|-T-X|TTXTT-TTTT-T||TXTT-||||TXX|TT|T-TTT-TT-T|TT|TTT-|X-T-TT|-TTTT|-||T||-T|-|TTT|-TXTT||T-|XT----|T|TXTX|X|TX|TTTXT||-|-TTToTTXTT|TXX-TT--||T||TTX-TXTT-T-|TTT--TT||T|T|TTT-TTT||XXT-TT|TT|T|TTTf
m||XXX-|XX|||-||XX||B-||||X|||||X||XXX-|X|-|||X|XX-||||X||-|XX|XX|X-||XXXXX||||X|X||X-X|X|X||XX|X|XX|X-XX|X|X|XXX||XX|X|X|XX||-|||X|||||X|XXXX|-X||XXX||X-|X||-|-|X||--X|-||XX||||-|X|||XXX-X|X|||-X||XX
XXXXXXXXXXXXXXXXXXXXXXXXXXXXXXXXXXXXXXXXXXXXXXXXXXXXXXXXXXXXXXXXXXXXXXXXXXXXXXXXXXXXXXXXXXXXXXXXXXXXXXXXXXXXXXXXXXXXXXXXXXXXXXXXXXXXXXXXXXXXXXXXXXXXXXXXXXXXXXXXXXXXXXXXXXXXXXXXXXXXXXXXXXXXXXXXXXXXXXXX
