--TEE-?-|EE-EX-XoX|----?--|--|X--B----M--E-MEX|T-T-|--T?|-T---B-?EX--T---MT-----XE?-|M--X--M-o----o|--o-|oM---E--M----E|-B--E-|oXMX-X-M-?|-??-T-X|T-T?TM-X|-|-?T--E?-------T-M--o---X-TTM-?--B|T------T-
-?--|E-T-TB?-------TTTB--?--?--------|-----M--oX-E--EB--?MBo-oXMEE|-EM--|BMX|?--M--BE-|BTT|o-?--|-M--TEE-|--T-----B?-BoT---E-EX-M-XET-----B--E-EB--B--?E-EX|----|E|----T----oE--B?-?M|-XoE?-T--E-----B--
-X?-E--o---TMBE----B----B?----|---T---BTT?oT-o-------B-B|--ET-?---o--Too-B---?----?-B--|X?--?----MTE--E-o----B?T---X?-T--------B---MX-EB--?----M?-oM-----|-----ET-???-E--oT?-|M----XTMX-X---|--|---|----
-|TT-----E-----o-B|-EB---E---?M-?--X--|E-T--B-E-----T--M--M-M-----?-X?|X-B?E---EE?|---MB-|---M--oBX--Eo-XMB-o---|----E---M------o-o------T--|o------|-X-----EBo-M-EM--M-B--EM----X-?E---X-E|E---T-X-o-M-
-----M------|---?oMB|-M--T-X-BXM-BMB?E------TB-EXE--|-MEE-B--|?o-BoE|X-oX?|------X-M-B-M-BX-------oB---o-EX---T-M--T-|M|---T?--o-X-BTEB?X--M----XT-?----M----|------o-?-T-X---o--|-----oXo-X---|--X--o|-
-E-T---?TT-----o---X----TX--------?--?-oBBEM-----?-oo-MB--oE-o--X--|-|--T?|--XX-M-BE-EB|-|----B--X-X|----Mo-----o---MM------X----T-M--oE-----T------B-ET---|-XM--o------o-|---TX|BMM--XE-oX-X?---B-?o---
-E-M----|-T--------Eo---E-XEB----XT?XoET-TTM-oE-M|?M-BB--o-?-TMB---|-X--XX--X-oB?----E-M-XEXMT---MB-oM-MXX-T-------E-|TTX-|-X-?-----|---BE-|-?ET-|oM-ToXT?M-o-|-----X|XE--?o--X-oMTT-X-T--To-B--TE-E-E--
-MM|-E--X--M--E-X-oTMXME--o--X-|---XT-o-ME--M--XX-E--XMo--X?-M-------?-oBM-BEX-E-----B---TXMB-T----T-MB-T----T-M--T-----?-|-BMBoBo-M----|-E?-?|--?XB-BB-|---E-|-MEo?--Bo-BoX-B?EEo--|--?--E-XEX-M--E?--v
--?-|X--T--E-BTM--B--o|M--o--B-?-----B-|---M--ME-o-M-M-MX-MM-?oXEo----T---------X-----?-BXo---X--Mo-B------E-o-TTo----?X-XT-?--T-|--X-o--X?---M-o--?X--BB-XM-B---?-|TX--E|Eo----E--E----||-------ME-T-Xf
----E-X--T---X---o-?-o|---?----T--o-|-|EXT-X-X-MB?Xo|?TB-?-?|BoBT-o---?-?EEXT-M-MM-EM-|---|E|T|----X|E----|?MB-oX?--?--EBM-BX?--?MT-|?--M-B-B?-M|-M--?|-o-M----B|?-E-----E------M-----X--B?--o--B|----|f
-EBE-BX---o---T-T|T?E?T---E?--XX--XB|--oXE-E|------X-|---|-BB-T-|E--MXEoX--|TBE-?-?-B--?--X|-B-T--TBo|?--?M---BBBM-?B|-----oE----o---T----|----E-E--M--TM--EBX-ToE--------E--o-B-EEET|T-----M-?-T--?--Bf
-----BB--To------E?--|E--T-BM---|-T----Too-B--BMT---B--B-T-M-E-o|--?-EEBX---B?--X---||BXM?---B------MB-X-B--E-o---BXX-oT--B--?BM-M--|----T-M|------o--o-XM-X--T--M?|---o---E--o----?-----TB-X----E-|-T|f
--------X---?T----oXB---?--oX--o--M--?ME-oT--|----T?-BB------|X--|--X---B-oMX?E---o-X-||-o------X-EE|-TE----X------------XM----X----|--|E-|?ToTE?||M-M-------?||-X-?--o-M-T|-o--oT--X?--T-M---X-??M-To-f
--?-T?oE---E|----EXE|--T-----oM|E----|--T--o-|-----M---o-TB----M-o--T-----o----E-----T-?E||-M|o---||---B?---|---------X---BXo--|-T--?oM---E-B----Xo?X--XMT-E-T-E---oTX-XB-------oB--X?oB--E?TToo------Tf
m-XX??--o---M------XT------?---|-BX||-?-TT-BEM-B----?BX--XB-o--M?-X-T--------|------X----B-TM-B--E-oM--o-E?-T-----|----X-|XEB----To-o-|-E--|M--BX|X--M?o-B-To--E---oE---?--|--ToM---Eo|---?---o?-EoTET-X
XXXXXXXXXXXXXXXXXXXXXXXXXXXXXXXXXXXXXXXXXXXXXXXXXXXXXXXXXXXXXXXXXXXXXXXXXXXXXXXXXXXXXXXXXXXXXXXXXXXXXXXXXXXXXXXXXXXXXXXXXXXXXXXXXXXXXXXXXXXXXXXXXXXXXXXXXXXXXXXXXXXXXXXXXXXXXXXXXXXXXXXXXXXXXXXXXXXXXXXX
