---EB-M--EE---?-XE-?--E-E-?-|X-X?M--E-----M--|-TX--B--EEE-X----|B-?|BM|---?E----B--X-ET--?E-ET--ME--M?o--?-T-?------ETE--X-?M-o-E-X---B----oT--E----?--|----oM-T----?-E-o--XE---EX-??--Xo||--M----Eo-X--
-?--?|T?-----T-M---TX--o--B-B-T--T--BM-M--|-|------|B-BX-B-E-|o-E-E-o?--B-BXoB--E--?-X-X-?---T-T-----EB-XX?------M----o?---|BTXM-|-B-|-X---|-TMBo-BM--E------EB--XB--M|-T------o-B----X--|To|-|--T-T--|-
-----B-B-----|M-o?-XXTo----ooM--Bo-------M-oX-|---M--TT---T---B|M-MMTTE-E-?T-T----T----B-----o-------o-B-o--?T--X?--M-BT-X-B?--?----MMB--?----MEB-?--?----B-------BM-X?B---Xo--M---M----B--?B-T-?T-EToE-
-MX-BBME---o--BT-|--ME-|--E--M-o--M--M--B|--||-?E|-?M-------E----o----X-----E--TE--T----??X--------|-o-BX--To??--MT-M|--X-B---M-BXXT|E--X|-o-X||B|-------XME|-------ME-------T?-?-M--TX-E--|-BooX---B-B-
----T-|-?|----|----X-EX-o|----T-BoEBE?-T-----|---?|B--?|XoE-E--B---o---M?E---T------X-BE-B---T-EoM-|----|---M-?-----B?B-----T-MX-To-|-----TEEE---o|------|?----|--X--|--o--B-oB---T-oTEE---?BoT--oMo|---
-E---oB--XXE|?XT-T--|B?-?--X-?-E-|X-?----X------o--TTX-B--TEM?T-|TT-MXB--o-M?-|--X--XT---TMX-E?|?-ETB-X-?------oT----o--EE|E|T?T---o---E|B------o-----|-MM---T---B-M--M?-E?E-BB--?--B-----|--EX-B--T--|-
-------BBE-|-??B---o-|-?-?B-XX--EX|MM-BB-B--?-------o-T-X-----o-----B--ME--?--MT-E--XTMMoEM--XE-----?EEo---E|??--BEEM-------oM---TM-T|--BTX--XEE---E---|---XEX--B---To-----------?----|-----???MT--oE---
-----T--|XEEX-|BX|----E?E--T-X---M----o---T--MXTET-Xo?-XMM--|------o---X-|-o---T-oB--|T--|T----?----o---|-----M-MX----M---T-ET---E?--E-M----|----X----E-o-|--o--M-T--|X-T---M--|-X--M-T|-----E-E|-E----v
--|-?---o--o-------MB-E--T-B-M--ME--T|-?-E|-B--M-o---XT----B-?---Mo-oo-o--Bo--oB---E-|-o-|---TXXM--X-B?--T|T---oT-T-M?---E-X-EX--X---o----|--BX?---EM-E---?--ET?o-MM|T|XMoXX--M-------o--?o------XE-BM-f
---EMT-MEM-B-E--E----T--------|X-X-o--o-TB----M-M-??-B--T----|---?-oBTT--T--|-M-E--E--oo-?----T-X--T---?-o-EoM----o---|T-T--T----|--EX--MoT|--oM--o-|--?--o--?E---TM-T-TX?o----M|-----TE-----EB--T---X-f
-M-B-----M-----TX--o?--?o--BX---o-B---E--M-----Bo-B-E-B------|--?------E|---|-T--?--oToBE---|MBo-|EE-E---X--MXM-B-B-M-T-TX-B----X--B-B---o--o-oo--T--------X---------M-M--B-|M----|?TE?M--|---E-EoE--XXf
--T-BoMT--o--E--o--M--?X-E?o-?B-o---BX??----|T-----oXX|--To------T-Xo-M---XBB-M-Xo----E----|--?-X-T--E?o-EM-Eo--E----o----o?Bo-o-M|----?---|?-o-B-?-?---XB---o|--BX-T--|--T-B---|?-----X|--TX----------f
---E--|-E-XE?-E--X-X---BBT--EM-------EX----B-M?--X--X-|--???X-----T--M--|-BX----T-E----M-Mo---B-E------|MBB-oE--XMEXE-X|EXo---?--|-X--------|--M-?----BTX-E-T|-o-X?-B--E---?-o?B---?-TXM--|M---EX--?-o-f
---T-|-E----|M-----------------o---?-B?-B?o|-o|---XMBT-|--M--Xo---BMo-T--|--oX?-?---?-?--XoT----E--?--M?X--E--MT|---X--|E-X--M?-XBo--?-----|-------o--E-T-----M--TE----|-M--oX-TT-M---E--|BT----TM|ETMXf
m-----o-|XEoEX-|B-oo-X-X---?--|oBTX?XX-E|-----o--BBE-B---E|-To-MT----M---|---M-T---|-|?--B-|?--|-------E|-XTX-B--?o?--?|TT-|--E--|-o-M-o-X-XXX-|-M--Eo----Booo|Eo--B--T-|---X-ET-o-EEX?|----XT-X--|oTX-X
XXXXXXXXXXXXXXXXXXXXXXXXXXXXXXXXXXXXXXXXXXXXXXXXXXXXXXXXXXXXXXXXXXXXXXXXXXXXXXXXXXXXXXXXXXXXXXXXXXXXXXXXXXXXXXXXXXXXXXXXXXXXXXXXXXXXXXXXXXXXXXXXXXXXXXXXXXXXXXXXXXXXXXXXXXXXXXXXXXXXXXXXXXXXXXXXXXXXXXXX
