--------------------------------------------------------------------------------------------------------------------------------------------------------------------------------------------------------
--------------------------------------------------------------------------------------------------------------------------------------------------------------------------------------------------------
--------------------------------------------------------------------------------------------------------------------------------------------------------------------------------------------------------
-B?----E---E---M----?-BM------------------M-M------E-?--------------------B--E-----M-----------M-------E-------------M-?---B-------------M--?-?---?----------------BM------------EM------------E--M---B-
----B-----------------MM-?--M--------M--M-----------------M-------------------??---?---BB-------------M---------------------------B-----M-----------?-----?----B-------------------M---M------?------B--
---B--B----------M---??-----ME-E---BB-------------E---------?-------E-------?M----E----B-------------?-----------------------B---------------------------------------M--EE---B-------B---B--?------E----
---B---------E----------------M-------------------------?--------M?--M--B-B-----M------E----B---E-M---M-------M-E--------------E--?-----------M----M--------?------------B--------------?--------?------
-B-B-B----?---BB-?-MB--M--------B---E?-M-----------M--------------?--M?-------------E-B-E-----------?----M-----------B--------------------------B------------M----------?----------------B-M-----------v
---E--------B----------BB----E----------E-E----??---B-----M--?----------------------E---B--------------?-------------B-M--B-E--------B--?--M-------------B-------M---E-----E-?--E------MB----?M------M-f
---------M-E--E---E-------------------------M-?------B-------?-----E---M--------------------------M---?-----M---------------M------B-?----------------MB------E-E-------EM----B??--------------M-------f
--?--------------M--------B-----------E---B----M--?-??-----E------------------M--------B----?---?---B-?---------E-------B-------M--------------------B-----?----B---------E---M---E-M-?-------------B-Bf
-B-------------------------------------?-------------------------B---------M-------E---------------------B-----E------------E---------?--------?-E----B------------M------------------B-----------?----f
-M--------M---B----?--B-------------?----------M----------M------?--------------?-------------------------MM---?-?B-M---MM-----------?---?---------E--------E-----?---------M-M--------M-----------?---f
----BE-E?-------EM-------M----------M-E--E-----B-BB------M---E---------------------M---------EB----?----------------B------------------------B-M----------E------B----?----B---------------------M-M---f
m-----------X-X--X?--B-----M----X--EB-----------X-----X-----X--BE--X--B-----------B?E-----MX---M--M-X-----X----------X-XX------X-E--?---BX-X-X-------MX--X--XX--X-?-?----------BB---E-----X----X-------X
XXXXXXXXXXXXXXXXXXXXXXXXX-XXX-X-XXXXXXXXXXXXXXXXXXXXXXXXXXXXXXXXXXXXXXXXXXXXXXXXXXXXXXXXXXXXXXXXXXXXXXXXXXXXXX-XXXXXXX-X-XXXXXX--XXXXXXXXXXXXXX--X-XXXXXXXXX-X-X-XXXXXXXXXXXX-XXXXXXXXX-X-X-XXXXXXXX-XXX
