--------------------------------------------------------------------------------------------------------------------------------------------------------------------------------------------------------
--------------------------------------------------------------------------------------------------------------------------------------------------------------------------------------------------------
--------------------------------------------------------------------------------------------------------------------------------------------------------------------------------------------------------
--------------------------------------------------------------------------------------------------------------------------------------------------------------------------------------------------------
--------------------------------------------------------------------------------------------------------------------------------------------------------------------------------------------------------
--------------------------------------------------------------------------------------------------------------------------------------------------------------------------------------------------------
--------------------------------------------------------------------------------------------------------------------------------------------------------------------------------------------------------
-------------------------------------------------------------------------------------------------------------------------------------------------------------------------------------------------------v
------------------T------------------------------------------------------------------------------------------------------------------------------------------------------------------------------------f
------------------|-----------------------------------------------------------------------T----------------------------------|------------------------------------------------------T------------------f
-----------|------T-----------------------------------------------------T-----------------T-----|-------------------------------T----------T-----------------------------------------------------------f
-----------|--------------------------------T---T----|--------------T--------------------|---------TT----T----------------------T-------|--|----T----T----|-----T-----------T-------T----------T-----|-f
-------------T--|------------T----|-----|---|---|-T--|-----|--|-----T--T-----T-------T---|---|-X---||--XT|--T-|-T--------T------|----X||--T---T-|--T-T---TX-TT--|----|------T------TX---T------|--T-T|-f
---|TT|X---X||-TXT|T--T-X--TX|----T-|X-TT-TTT-|X|-|T|TTX-T-T-TT-X---T--||X---|-X--T--X|T-XT-X|-XXT-X-T-XTT|T|-TTTTT-TT|-T|T--|-TT---|XTTT-|---|X|T-TT|T--XX-|X-TXXT-TXT-||--XX--|-X|X-TTTT-----TT-|T|TXf
mX-||||XXXXXXX-|X||XXX|XX|X|XX-XXX|X|XX||X|||-XX||X||X|XX|X|X||-X|X|||-X|X|X||-XXX|--XX|XXXXXXX-X|XXX|-X|||||-|||X|X||X||XX-XX-X|XX-|X|||XXX-XXXX|-||XXX-X|-XXX|XX|-|-|X||--X-|-|XXX-X|||||X|X-||X||X|-X
XXXXXXXXXXXXXXXXXXXXXXXXXXXXXXXXXXXXXXXXXXXXXXXXXXXXXXXXXXXXXXXXXXXXXXXXXXXXXXXXXXXXXXXXXXXXXXXXXXXXXXXXXXXXXXXXXXXXXXXXXXXXXXXXXXXXXXXXXXXXXXXXXXXXXXXXXXXXXXXXXXXXXXXXXXXXXXXXXXXXXXXXXXXXXXXXXXXXXXXX
