--------------------------------------------------------------------------------------------------------------------------------------------------------------------------------------------------------
--------------------------------------------------------------------------------------------------------------------------------------------------------------------------------------------------------
--------------------------------------------------------------------------------------------------------------------------------------------------------------------------------------------------------
--------------------------------------------------------------------------------------------------------------------------------------------------------------------------------------------------------
--------------------------------------------------------------------------------------------------------------------------------------------------------------------------------------------------------
--------------------------------------------------------------------------------------------------------------------------------------------------------------------------------------------------------
--------------------------------------------------------------------------------------------------------------------------------------------------------------------------------------------------------
-------------------------------------------------------------------------------------------------------------------------------------------------------------------------------------------------------v
-------------------------------------------------------------------------------------------------------------------------------------------------------------------------------------------------------f
-------------------------------------------------------------------------------------------------------------------------------------------------------------------------------------------------------f
------T--------------------------T-------------------------------------------------------T-------------------------------------------------------------------------------------------------------------f
--|T-|TT-T------------------------------------------------------------|T---------------------T----|--------|--T----------T|---TT---------TT-T----T-----T-T---T---------------T--T-----T----------------f
--|--|||T--|T------T--T-T--------T--------T------T-TT-TTTT----T--|-TT-||-T-|-T-T-TTX--T--|--||----|-----TT-|-TTT------T--|TTT-TT--|T---|-T----T------T-T-|T|---T---T-T-------|--T-T---T--T-T--TT---|---f
--T-TT||TT-|T-T-|-|T--|T||X-TT--TT---TT-T||-T---X--XT|T|T|XTX|T-|T-|T-TTT-T|XT-T||T|-TT-TT-XTT-TTTXTT---T-XTT|-|-TX---T--|||TTX---|TTTTXT|----TT-|-T||TTXT||-X-----|-T|X||---T-||-|TX-X-TT||TT|T--|X-T-f
m-|-|XX||XXX|---|-||XXX|X|X---XX-||X|X|-X-X--|X-X-XX|X||-|XXXX|X|||X|X|X|--XX|-|X||X--|-X|XX|X--||X-X--X|--XXXX|-XXXXX|-||||||XXXXX|-X|X|XX||-|-X|-X|XX|||X|-X----|XX|XX|XXX-|||XXXXXXX||||X|||X-X|X-|-X
XXXXXXXXXXXXXXXXXXXXXXXXXXXXXXXXXXXXXXXXXXXXXXXXXXXXXXXXXXXXXXXXXXXXXXXXXXXXXXXXXXXXXXXXXXXXXXXXXXXXXXXXXXXXXXXXXXXXXXXXXXXXXXXXXXXXXXXXXXXXXXXXXXXXXXXXXXXXXXXXXXXXXXXXXXXXXXXXXXXXXXXXXXXXXXXXXXXXXXXX
