--------------------------------------------------------------------------------------------------------------------------------------------------------------------------------------------------------
--------------------------------------------------------------------------------------------------------------------------------------------------------------------------------------------------------
--------------------------------------------------------------------------------------------------------------------------------------------------------------------------------------------------------
------------------?------------M-----B---M-----------E----?-------------------------------?-------------M----------M-----B------------M---B------------?---------------------E-------B--M---E-?---------
--------------------MB----------------B-?--?--------B?-------------------------------?----------------?----------------------------------?---------M?M---------------------------------------------B----
--?--------------------------M---------------------------------------------------------------------------------E---------------?-----------------E-------------------------------------------------BB---
-B---?----------------------E-------------B-B----------------------M--------M-----------E----------------------------?--E-----------------------------ME------M----E-----B------------?-----------------
--------E----M-E----------------B---------------------B-----------------------M---E---------B---------?--------------?------------?-?------E------------------?-------------M-------------B?-----------v
--?---M----B-------E---------------------------------------------------------------------------------------M-------------------M----------M----------------?---------?----------------------B----------f
-------E------E----------EM----------------M-----B--B-----------------------------B---------M---------------M-M------?--?--------------B----------------------------------------B----------------------f
--ME-----------------------------------E--------------?----M----B-----------------BE-EE--------E-E-----M----------------M---------------------M---B--E?E---------B-------------------E------------M----f
---------------M--------------?------M---------------?----------------------E----------------E---------E----------------B----------------M-M------------------------------M---E-----------B-----------?f
-------------------------B-M-------------E---------E---------?------------------------------?-------------------M-----------------------E-----------E--E-----------------E-E--------------M------------f
------E--------------B--------------------B---------------------E-------------?--------------------?----------------------------B----------------------------------------------------------------------f
m---EB-------T-?T--------------T-----T----T-----T----B---------X--B---T-X?X-------------T-T---------X---------TM---T---M-----X---------B---T----T--M-X--X--TTT------------B-------T---T----------------X
XXXXXXXXXXXXXXXXXXXXXX-XX-XXXXXXXXXXXXXXXXXXXXXXXXXXXXXXXXXXXXXXXXXXXXX-XXX-XXXXXXXXXXXXXXXXXXXXXXXXX-XXX-XXXXXXXXXXXXX-XXXXXX-XXXXXXXXXXXXXXXXXXXX-XXXXXXXXXXXXXXXXXXXXXXXXXXXXXXXXXXXXXXXXXXXXXXXXXXXX
